ronda_num,agente_nombre,capital_inicial_ronda,capital_final_ronda,ganancia_neta_ronda,apuesta_total_ronda,resultado_ronda,cartas_restantes_mazo
1,AgenteBasico,90000000,89999995,-5,5,-1,208
2,AgenteBasico,89999995,90000002,7,5,1,202
3,AgenteBasico,90000002,89999997,-5,5,-1,197
4,AgenteBasico,89999997,89999992,-5,5,-1,192
5,AgenteBasico,89999992,89999987,-5,5,-1,187
6,AgenteBasico,89999987,89999982,-5,5,-1,182
7,AgenteBasico,89999982,89999977,-5,5,-1,176
8,AgenteBasico,89999977,89999977,0,5,0,168
9,AgenteBasico,89999977,89999977,0,5,0,164
10,AgenteBasico,89999977,89999982,5,5,1,159
11,AgenteBasico,89999982,89999979,-3,0,-1,153
12,AgenteBasico,89999979,89999974,-5,5,-1,148
13,AgenteBasico,89999974,89999969,-5,5,-1,142
14,AgenteBasico,89999969,89999966,-3,0,-1,136
15,AgenteBasico,89999966,89999966,0,5,0,131
16,AgenteBasico,89999966,89999966,0,5,0,127
17,AgenteBasico,89999966,89999973,7,5,1,123
18,AgenteBasico,89999973,89999968,-5,5,-1,119
19,AgenteBasico,89999968,89999963,-5,5,-1,112
20,AgenteBasico,89999963,89999973,10,10,1,106
21,AgenteBasico,89999973,89999968,-5,5,-1,100
22,AgenteBasico,89999968,89999968,0,10,0,95
23,AgenteBasico,89999968,89999963,-5,5,-1,87
24,AgenteBasico,89999963,89999958,-5,5,-1,81
25,AgenteBasico,89999958,89999958,0,5,0,71
26,AgenteBasico,89999958,89999953,-5,5,-1,66
27,AgenteBasico,89999953,89999953,0,5,0,60
28,AgenteBasico,89999953,89999948,-5,5,-1,55
29,AgenteBasico,89999948,89999943,-5,5,-1,49
30,AgenteBasico,89999943,89999938,-5,5,-1,204
31,AgenteBasico,89999938,89999938,0,5,0,199
32,AgenteBasico,89999938,89999933,-5,5,-1,189
33,AgenteBasico,89999933,89999928,-5,5,-1,184
34,AgenteBasico,89999928,89999923,-5,5,-1,178
35,AgenteBasico,89999923,89999928,5,5,1,173
36,AgenteBasico,89999928,89999933,5,5,1,166
37,AgenteBasico,89999933,89999928,-5,5,-1,159
38,AgenteBasico,89999928,89999923,-5,5,-1,152
39,AgenteBasico,89999923,89999923,0,5,0,148
40,AgenteBasico,89999923,89999918,-5,5,-1,141
41,AgenteBasico,89999918,89999913,-5,5,-1,137
42,AgenteBasico,89999913,89999908,-5,5,-1,132
43,AgenteBasico,89999908,89999905,-3,0,-1,127
44,AgenteBasico,89999905,89999902,-3,0,-1,123
45,AgenteBasico,89999902,89999902,0,10,0,119
46,AgenteBasico,89999902,89999897,-5,5,-1,114
47,AgenteBasico,89999897,89999897,0,5,0,109
48,AgenteBasico,89999897,89999897,0,5,0,105
49,AgenteBasico,89999897,89999902,5,5,1,99
50,AgenteBasico,89999902,89999897,-5,5,-1,93
51,AgenteBasico,89999897,89999897,0,5,0,88
52,AgenteBasico,89999897,89999892,-5,5,-1,82
53,AgenteBasico,89999892,89999892,0,5,0,74
54,AgenteBasico,89999892,89999887,-5,5,-1,69
55,AgenteBasico,89999887,89999884,-3,0,-1,64
56,AgenteBasico,89999884,89999889,5,5,1,60
57,AgenteBasico,89999889,89999889,0,5,0,54
58,AgenteBasico,89999889,89999889,0,10,0,50
59,AgenteBasico,89999889,89999884,-5,5,-1,44
60,AgenteBasico,89999884,89999884,0,5,0,202
61,AgenteBasico,89999884,89999889,5,5,1,197
62,AgenteBasico,89999889,89999884,-5,5,-1,191
63,AgenteBasico,89999884,89999891,7,5,1,186
64,AgenteBasico,89999891,89999896,5,5,1,181
65,AgenteBasico,89999896,89999891,-5,5,-1,176
66,AgenteBasico,89999891,89999896,5,5,1,172
67,AgenteBasico,89999896,89999896,0,5,0,166
68,AgenteBasico,89999896,89999896,0,5,0,162
69,AgenteBasico,89999896,89999901,5,5,1,157
70,AgenteBasico,89999901,89999911,10,10,1,152
71,AgenteBasico,89999911,89999906,-5,5,-1,145
72,AgenteBasico,89999906,89999911,5,5,1,140
73,AgenteBasico,89999911,89999906,-5,5,-1,135
74,AgenteBasico,89999906,89999896,-10,10,-1,129
75,AgenteBasico,89999896,89999891,-5,5,-1,122
76,AgenteBasico,89999891,89999891,0,5,0,116
77,AgenteBasico,89999891,89999886,-5,5,-1,111
78,AgenteBasico,89999886,89999886,0,5,0,105
79,AgenteBasico,89999886,89999881,-5,5,-1,99
80,AgenteBasico,89999881,89999881,0,5,0,95
81,AgenteBasico,89999881,89999886,5,5,1,91
82,AgenteBasico,89999886,89999893,7,5,1,84
83,AgenteBasico,89999893,89999898,5,5,1,80
84,AgenteBasico,89999898,89999895,-3,0,-1,74
85,AgenteBasico,89999895,89999890,-5,5,-1,69
86,AgenteBasico,89999890,89999885,-5,5,-1,62
87,AgenteBasico,89999885,89999880,-5,5,-1,56
88,AgenteBasico,89999880,89999880,0,5,0,49
89,AgenteBasico,89999880,89999880,0,5,0,45
90,AgenteBasico,89999880,89999880,0,10,0,41
91,AgenteBasico,89999880,89999880,0,5,0,36
92,AgenteBasico,89999880,89999880,0,5,0,204
93,AgenteBasico,89999880,89999887,7,5,1,199
94,AgenteBasico,89999887,89999877,-10,10,-1,193
95,AgenteBasico,89999877,89999872,-5,5,-1,187
96,AgenteBasico,89999872,89999867,-5,5,-1,183
97,AgenteBasico,89999867,89999872,5,5,1,177
98,AgenteBasico,89999872,89999877,5,5,1,172
99,AgenteBasico,89999877,89999877,0,5,0,167
100,AgenteBasico,89999877,89999877,0,5,0,163
101,AgenteBasico,89999877,89999877,0,5,0,158
102,AgenteBasico,89999877,89999874,-3,0,-1,154
103,AgenteBasico,89999874,89999874,0,5,0,149
104,AgenteBasico,89999874,89999879,5,5,1,145
105,AgenteBasico,89999879,89999874,-5,5,-1,139
106,AgenteBasico,89999874,89999879,5,5,1,132
107,AgenteBasico,89999879,89999876,-3,0,-1,127
108,AgenteBasico,89999876,89999871,-5,5,-1,123
109,AgenteBasico,89999871,89999871,0,10,0,117
110,AgenteBasico,89999871,89999881,10,10,1,111
111,AgenteBasico,89999881,89999891,10,10,1,104
112,AgenteBasico,89999891,89999886,-5,5,-1,97
113,AgenteBasico,89999886,89999891,5,5,1,92
114,AgenteBasico,89999891,89999886,-5,5,-1,87
115,AgenteBasico,89999886,89999891,5,5,1,81
116,AgenteBasico,89999891,89999901,10,10,1,76
117,AgenteBasico,89999901,89999901,0,5,0,67
118,AgenteBasico,89999901,89999896,-5,5,-1,61
119,AgenteBasico,89999896,89999906,10,10,1,55
120,AgenteBasico,89999906,89999906,0,5,0,49
121,AgenteBasico,89999906,89999901,-5,5,-1,43
122,AgenteBasico,89999901,89999896,-5,5,-1,203
123,AgenteBasico,89999896,89999903,7,5,1,197
124,AgenteBasico,89999903,89999898,-5,5,-1,193
125,AgenteBasico,89999898,89999898,0,10,0,187
126,AgenteBasico,89999898,89999898,0,5,0,181
127,AgenteBasico,89999898,89999898,0,5,0,177
128,AgenteBasico,89999898,89999905,7,5,1,172
129,AgenteBasico,89999905,89999910,5,5,1,166
130,AgenteBasico,89999910,89999915,5,5,1,160
131,AgenteBasico,89999915,89999910,-5,5,-1,154
132,AgenteBasico,89999910,89999915,5,5,1,149
133,AgenteBasico,89999915,89999915,0,10,0,144
134,AgenteBasico,89999915,89999925,10,10,1,138
135,AgenteBasico,89999925,89999925,0,5,0,131
136,AgenteBasico,89999925,89999930,5,5,1,126
137,AgenteBasico,89999930,89999930,0,10,0,121
138,AgenteBasico,89999930,89999930,0,5,0,115
139,AgenteBasico,89999930,89999925,-5,5,-1,110
140,AgenteBasico,89999925,89999920,-5,5,-1,103
141,AgenteBasico,89999920,89999915,-5,5,-1,98
142,AgenteBasico,89999915,89999905,-10,10,-1,93
143,AgenteBasico,89999905,89999900,-5,5,-1,88
144,AgenteBasico,89999900,89999910,10,10,1,82
145,AgenteBasico,89999910,89999910,0,5,0,75
146,AgenteBasico,89999910,89999920,10,10,1,71
147,AgenteBasico,89999920,89999915,-5,5,-1,64
148,AgenteBasico,89999915,89999905,-10,10,-1,60
149,AgenteBasico,89999905,89999900,-5,5,-1,55
150,AgenteBasico,89999900,89999905,5,5,1,49
151,AgenteBasico,89999905,89999910,5,5,1,44
152,AgenteBasico,89999910,89999905,-5,5,-1,39
153,AgenteBasico,89999905,89999910,5,5,1,204
154,AgenteBasico,89999910,89999915,5,5,1,198
155,AgenteBasico,89999915,89999910,-5,5,-1,192
156,AgenteBasico,89999910,89999905,-5,5,-1,187
157,AgenteBasico,89999905,89999900,-5,5,-1,180
158,AgenteBasico,89999900,89999900,0,5,0,174
159,AgenteBasico,89999900,89999900,0,5,0,170
160,AgenteBasico,89999900,89999900,0,5,0,166
161,AgenteBasico,89999900,89999895,-5,5,-1,160
162,AgenteBasico,89999895,89999895,0,5,0,154
163,AgenteBasico,89999895,89999900,5,5,1,148
164,AgenteBasico,89999900,89999897,-3,0,-1,143
165,AgenteBasico,89999897,89999904,7,5,1,139
166,AgenteBasico,89999904,89999909,5,5,1,135
167,AgenteBasico,89999909,89999899,-10,10,-1,129
168,AgenteBasico,89999899,89999894,-5,5,-1,122
169,AgenteBasico,89999894,89999899,5,5,1,117
170,AgenteBasico,89999899,89999894,-5,5,-1,110
171,AgenteBasico,89999894,89999899,5,5,1,105
172,AgenteBasico,89999899,89999899,0,5,0,100
173,AgenteBasico,89999899,89999896,-3,0,-1,94
174,AgenteBasico,89999896,89999901,5,5,1,90
175,AgenteBasico,89999901,89999901,0,5,0,84
176,AgenteBasico,89999901,89999891,-10,10,-1,79
177,AgenteBasico,89999891,89999901,10,10,1,73
178,AgenteBasico,89999901,89999906,5,5,1,64
179,AgenteBasico,89999906,89999901,-5,5,-1,58
180,AgenteBasico,89999901,89999906,5,5,1,53
181,AgenteBasico,89999906,89999906,0,5,0,48
182,AgenteBasico,89999906,89999906,0,5,0,42
183,AgenteBasico,89999906,89999913,7,5,1,34
184,AgenteBasico,89999913,89999908,-5,5,-1,203
185,AgenteBasico,89999908,89999908,0,5,0,199
186,AgenteBasico,89999908,89999913,5,5,1,195
187,AgenteBasico,89999913,89999918,5,5,1,189
188,AgenteBasico,89999918,89999913,-5,5,-1,181
189,AgenteBasico,89999913,89999908,-5,5,-1,175
190,AgenteBasico,89999908,89999903,-5,5,-1,170
191,AgenteBasico,89999903,89999898,-5,5,-1,165
192,AgenteBasico,89999898,89999893,-5,5,-1,158
193,AgenteBasico,89999893,89999893,0,5,0,151
194,AgenteBasico,89999893,89999908,15,15,1,146
195,AgenteBasico,89999908,89999915,7,5,1,136
196,AgenteBasico,89999915,89999915,0,5,0,131
197,AgenteBasico,89999915,89999920,5,5,1,124
198,AgenteBasico,89999920,89999915,-5,5,-1,117
199,AgenteBasico,89999915,89999905,-10,10,-1,113
200,AgenteBasico,89999905,89999900,-5,5,-1,106
201,AgenteBasico,89999900,89999897,-3,0,-1,101
202,AgenteBasico,89999897,89999894,-3,0,-1,97
203,AgenteBasico,89999894,89999899,5,5,1,93
204,AgenteBasico,89999899,89999894,-5,5,-1,88
205,AgenteBasico,89999894,89999884,-10,10,-1,84
206,AgenteBasico,89999884,89999889,5,5,1,79
207,AgenteBasico,89999889,89999884,-5,5,-1,73
208,AgenteBasico,89999884,89999879,-5,5,-1,67
209,AgenteBasico,89999879,89999884,5,5,1,60
210,AgenteBasico,89999884,89999884,0,5,0,53
211,AgenteBasico,89999884,89999879,-5,5,-1,47
212,AgenteBasico,89999879,89999879,0,5,0,42
213,AgenteBasico,89999879,89999879,0,5,0,36
214,AgenteBasico,89999879,89999886,7,5,1,30
215,AgenteBasico,89999886,89999881,-5,5,-1,204
216,AgenteBasico,89999881,89999888,7,5,1,197
217,AgenteBasico,89999888,89999883,-5,5,-1,192
218,AgenteBasico,89999883,89999878,-5,5,-1,187
219,AgenteBasico,89999878,89999883,5,5,1,183
220,AgenteBasico,89999883,89999883,0,5,0,177
221,AgenteBasico,89999883,89999878,-5,5,-1,172
222,AgenteBasico,89999878,89999873,-5,5,-1,167
223,AgenteBasico,89999873,89999878,5,5,1,162
224,AgenteBasico,89999878,89999873,-5,5,-1,154
225,AgenteBasico,89999873,89999868,-5,5,-1,148
226,AgenteBasico,89999868,89999873,5,5,1,143
227,AgenteBasico,89999873,89999873,0,5,0,135
228,AgenteBasico,89999873,89999868,-5,5,-1,131
229,AgenteBasico,89999868,89999868,0,5,0,124
230,AgenteBasico,89999868,89999878,10,10,1,119
231,AgenteBasico,89999878,89999883,5,5,1,112
232,AgenteBasico,89999883,89999888,5,5,1,107
233,AgenteBasico,89999888,89999883,-5,5,-1,101
234,AgenteBasico,89999883,89999878,-5,5,-1,95
235,AgenteBasico,89999878,89999888,10,10,1,90
236,AgenteBasico,89999888,89999898,10,10,1,84
237,AgenteBasico,89999898,89999898,0,5,0,78
238,AgenteBasico,89999898,89999893,-5,5,-1,71
239,AgenteBasico,89999893,89999890,-3,0,-1,66
240,AgenteBasico,89999890,89999890,0,5,0,62
241,AgenteBasico,89999890,89999890,0,5,0,58
242,AgenteBasico,89999890,89999885,-5,5,-1,53
243,AgenteBasico,89999885,89999890,5,5,1,47
244,AgenteBasico,89999890,89999895,5,5,1,41
245,AgenteBasico,89999895,89999902,7,5,1,34
246,AgenteBasico,89999902,89999902,0,5,0,203
247,AgenteBasico,89999902,89999897,-5,5,-1,199
248,AgenteBasico,89999897,89999897,0,5,0,194
249,AgenteBasico,89999897,89999892,-5,5,-1,190
250,AgenteBasico,89999892,89999892,0,5,0,184
251,AgenteBasico,89999892,89999887,-5,5,-1,180
252,AgenteBasico,89999887,89999892,5,5,1,172
253,AgenteBasico,89999892,89999897,5,5,1,166
254,AgenteBasico,89999897,89999902,5,5,1,161
255,AgenteBasico,89999902,89999899,-3,0,-1,153
256,AgenteBasico,89999899,89999889,-10,10,-1,149
257,AgenteBasico,89999889,89999884,-5,5,-1,143
258,AgenteBasico,89999884,89999889,5,5,1,138
259,AgenteBasico,89999889,89999894,5,5,1,132
260,AgenteBasico,89999894,89999889,-5,5,-1,126
261,AgenteBasico,89999889,89999884,-5,5,-1,121
262,AgenteBasico,89999884,89999879,-5,5,-1,115
263,AgenteBasico,89999879,89999884,5,5,1,109
264,AgenteBasico,89999884,89999884,0,5,0,102
265,AgenteBasico,89999884,89999874,-10,10,-1,96
266,AgenteBasico,89999874,89999869,-5,5,-1,89
267,AgenteBasico,89999869,89999864,-5,5,-1,85
268,AgenteBasico,89999864,89999869,5,5,1,80
269,AgenteBasico,89999869,89999874,5,5,1,74
270,AgenteBasico,89999874,89999879,5,5,1,69
271,AgenteBasico,89999879,89999874,-5,5,-1,64
272,AgenteBasico,89999874,89999864,-10,10,-1,58
273,AgenteBasico,89999864,89999869,5,5,1,50
274,AgenteBasico,89999869,89999869,0,5,0,45
275,AgenteBasico,89999869,89999864,-5,5,-1,40
276,AgenteBasico,89999864,89999861,-3,0,-1,34
277,AgenteBasico,89999861,89999866,5,5,1,203
278,AgenteBasico,89999866,89999871,5,5,1,196
279,AgenteBasico,89999871,89999866,-5,5,-1,191
280,AgenteBasico,89999866,89999866,0,5,0,185
281,AgenteBasico,89999866,89999861,-5,5,-1,179
282,AgenteBasico,89999861,89999861,0,5,0,172
283,AgenteBasico,89999861,89999871,10,10,1,167
284,AgenteBasico,89999871,89999876,5,5,1,161
285,AgenteBasico,89999876,89999881,5,5,1,156
286,AgenteBasico,89999881,89999876,-5,5,-1,149
287,AgenteBasico,89999876,89999876,0,5,0,143
288,AgenteBasico,89999876,89999871,-5,5,-1,139
289,AgenteBasico,89999871,89999866,-5,5,-1,134
290,AgenteBasico,89999866,89999861,-5,5,-1,129
291,AgenteBasico,89999861,89999856,-5,5,-1,123
292,AgenteBasico,89999856,89999856,0,5,0,116
293,AgenteBasico,89999856,89999861,5,5,1,112
294,AgenteBasico,89999861,89999856,-5,5,-1,107
295,AgenteBasico,89999856,89999851,-5,5,-1,102
296,AgenteBasico,89999851,89999856,5,5,1,96
297,AgenteBasico,89999856,89999853,-3,0,-1,91
298,AgenteBasico,89999853,89999850,-3,0,-1,87
299,AgenteBasico,89999850,89999845,-5,5,-1,83
300,AgenteBasico,89999845,89999852,7,5,1,77
301,AgenteBasico,89999852,89999847,-5,5,-1,73
302,AgenteBasico,89999847,89999852,5,5,1,68
303,AgenteBasico,89999852,89999847,-5,5,-1,62
304,AgenteBasico,89999847,89999842,-5,5,-1,57
305,AgenteBasico,89999842,89999842,0,5,0,52
306,AgenteBasico,89999842,89999839,-3,0,-1,44
307,AgenteBasico,89999839,89999834,-5,5,-1,204
308,AgenteBasico,89999834,89999829,-5,5,-1,198
309,AgenteBasico,89999829,89999824,-5,5,-1,191
310,AgenteBasico,89999824,89999819,-5,5,-1,187
311,AgenteBasico,89999819,89999824,5,5,1,181
312,AgenteBasico,89999824,89999829,5,5,1,176
313,AgenteBasico,89999829,89999824,-5,5,-1,168
314,AgenteBasico,89999824,89999824,0,5,0,163
315,AgenteBasico,89999824,89999819,-5,5,-1,157
316,AgenteBasico,89999819,89999814,-5,5,-1,151
317,AgenteBasico,89999814,89999809,-5,5,-1,147
318,AgenteBasico,89999809,89999804,-5,5,-1,142
319,AgenteBasico,89999804,89999794,-10,10,-1,137
320,AgenteBasico,89999794,89999794,0,5,0,130
321,AgenteBasico,89999794,89999784,-10,10,-1,125
322,AgenteBasico,89999784,89999779,-5,5,-1,120
323,AgenteBasico,89999779,89999769,-10,10,-1,114
324,AgenteBasico,89999769,89999766,-3,0,-1,108
325,AgenteBasico,89999766,89999768,2,5,1,104
326,AgenteBasico,89999768,89999778,10,10,1,97
327,AgenteBasico,89999778,89999788,10,10,1,91
328,AgenteBasico,89999788,89999788,0,5,0,85
329,AgenteBasico,89999788,89999798,10,10,1,80
330,AgenteBasico,89999798,89999793,-5,5,-1,73
331,AgenteBasico,89999793,89999793,0,5,0,68
332,AgenteBasico,89999793,89999798,5,5,1,63
333,AgenteBasico,89999798,89999793,-5,5,-1,57
334,AgenteBasico,89999793,89999798,5,5,1,51
335,AgenteBasico,89999798,89999803,5,5,1,46
336,AgenteBasico,89999803,89999803,0,5,0,41
337,AgenteBasico,89999803,89999803,0,5,0,37
338,AgenteBasico,89999803,89999803,0,5,0,32
339,AgenteBasico,89999803,89999808,5,5,1,203
340,AgenteBasico,89999808,89999813,5,5,1,197
341,AgenteBasico,89999813,89999813,0,5,0,191
342,AgenteBasico,89999813,89999808,-5,5,-1,186
343,AgenteBasico,89999808,89999803,-5,5,-1,181
344,AgenteBasico,89999803,89999800,-3,0,-1,176
345,AgenteBasico,89999800,89999795,-5,5,-1,172
346,AgenteBasico,89999795,89999800,5,5,1,166
347,AgenteBasico,89999800,89999795,-5,5,-1,157
348,AgenteBasico,89999795,89999805,10,10,1,150
349,AgenteBasico,89999805,89999800,-5,5,-1,144
350,AgenteBasico,89999800,89999795,-5,5,-1,138
351,AgenteBasico,89999795,89999800,5,5,1,134
352,AgenteBasico,89999800,89999805,5,5,1,127
353,AgenteBasico,89999805,89999800,-5,5,-1,121
354,AgenteBasico,89999800,89999795,-5,5,-1,116
355,AgenteBasico,89999795,89999792,-3,0,-1,111
356,AgenteBasico,89999792,89999787,-5,5,-1,106
357,AgenteBasico,89999787,89999787,0,5,0,98
358,AgenteBasico,89999787,89999792,5,5,1,92
359,AgenteBasico,89999792,89999797,5,5,1,87
360,AgenteBasico,89999797,89999797,0,5,0,82
361,AgenteBasico,89999797,89999794,-3,0,-1,77
362,AgenteBasico,89999794,89999784,-10,10,-1,73
363,AgenteBasico,89999784,89999781,-3,0,-1,67
364,AgenteBasico,89999781,89999781,0,5,0,63
365,AgenteBasico,89999781,89999791,10,10,1,58
366,AgenteBasico,89999791,89999786,-5,5,-1,49
367,AgenteBasico,89999786,89999786,0,5,0,43
368,AgenteBasico,89999786,89999781,-5,5,-1,203
369,AgenteBasico,89999781,89999776,-5,5,-1,196
370,AgenteBasico,89999776,89999783,7,5,1,191
371,AgenteBasico,89999783,89999773,-10,10,-1,186
372,AgenteBasico,89999773,89999768,-5,5,-1,180
373,AgenteBasico,89999768,89999773,5,5,1,174
374,AgenteBasico,89999773,89999768,-5,5,-1,169
375,AgenteBasico,89999768,89999768,0,5,0,165
376,AgenteBasico,89999768,89999768,0,5,0,159
377,AgenteBasico,89999768,89999763,-5,5,-1,155
378,AgenteBasico,89999763,89999763,0,10,0,148
379,AgenteBasico,89999763,89999768,5,5,1,142
380,AgenteBasico,89999768,89999765,-3,0,-1,136
381,AgenteBasico,89999765,89999760,-5,5,-1,131
382,AgenteBasico,89999760,89999755,-5,5,-1,126
383,AgenteBasico,89999755,89999760,5,5,1,120
384,AgenteBasico,89999760,89999750,-10,10,-1,114
385,AgenteBasico,89999750,89999755,5,5,1,109
386,AgenteBasico,89999755,89999750,-5,5,-1,104
387,AgenteBasico,89999750,89999745,-5,5,-1,100
388,AgenteBasico,89999745,89999765,20,20,1,93
389,AgenteBasico,89999765,89999765,0,10,0,84
390,AgenteBasico,89999765,89999765,0,5,0,79
391,AgenteBasico,89999765,89999765,0,5,0,74
392,AgenteBasico,89999765,89999770,5,5,1,68
393,AgenteBasico,89999770,89999770,0,5,0,63
394,AgenteBasico,89999770,89999765,-5,5,-1,58
395,AgenteBasico,89999765,89999760,-5,5,-1,52
396,AgenteBasico,89999760,89999755,-5,5,-1,45
397,AgenteBasico,89999755,89999750,-5,5,-1,39
398,AgenteBasico,89999750,89999750,0,5,0,34
399,AgenteBasico,89999750,89999745,-5,5,-1,28
400,AgenteBasico,89999745,89999740,-5,5,-1,203
401,AgenteBasico,89999740,89999745,5,5,1,197
402,AgenteBasico,89999745,89999745,0,10,0,192
403,AgenteBasico,89999745,89999740,-5,5,-1,187
404,AgenteBasico,89999740,89999745,5,5,1,181
405,AgenteBasico,89999745,89999740,-5,5,-1,176
406,AgenteBasico,89999740,89999740,0,5,0,172
407,AgenteBasico,89999740,89999750,10,10,1,167
408,AgenteBasico,89999750,89999745,-5,5,-1,161
409,AgenteBasico,89999745,89999740,-5,5,-1,153
410,AgenteBasico,89999740,89999735,-5,5,-1,146
411,AgenteBasico,89999735,89999730,-5,5,-1,142
412,AgenteBasico,89999730,89999725,-5,5,-1,137
413,AgenteBasico,89999725,89999735,10,10,1,132
414,AgenteBasico,89999735,89999730,-5,5,-1,126
415,AgenteBasico,89999730,89999730,0,5,0,121
416,AgenteBasico,89999730,89999725,-5,5,-1,117
417,AgenteBasico,89999725,89999720,-5,5,-1,110
418,AgenteBasico,89999720,89999725,5,5,1,106
419,AgenteBasico,89999725,89999720,-5,5,-1,101
420,AgenteBasico,89999720,89999727,7,5,1,97
421,AgenteBasico,89999727,89999727,0,5,0,92
422,AgenteBasico,89999727,89999722,-5,5,-1,87
423,AgenteBasico,89999722,89999712,-10,10,-1,82
424,AgenteBasico,89999712,89999707,-5,5,-1,76
425,AgenteBasico,89999707,89999697,-10,10,-1,71
426,AgenteBasico,89999697,89999697,0,5,0,65
427,AgenteBasico,89999697,89999692,-5,5,-1,59
428,AgenteBasico,89999692,89999687,-5,5,-1,53
429,AgenteBasico,89999687,89999692,5,5,1,46
430,AgenteBasico,89999692,89999692,0,5,0,40
431,AgenteBasico,89999692,89999697,5,5,1,32
432,AgenteBasico,89999697,89999697,0,10,0,202
433,AgenteBasico,89999697,89999697,0,5,0,196
434,AgenteBasico,89999697,89999697,0,5,0,190
435,AgenteBasico,89999697,89999692,-5,5,-1,186
436,AgenteBasico,89999692,89999687,-5,5,-1,181
437,AgenteBasico,89999687,89999682,-5,5,-1,176
438,AgenteBasico,89999682,89999682,0,10,0,169
439,AgenteBasico,89999682,89999682,0,5,0,164
440,AgenteBasico,89999682,89999677,-5,5,-1,159
441,AgenteBasico,89999677,89999674,-3,0,-1,154
442,AgenteBasico,89999674,89999679,5,5,1,150
443,AgenteBasico,89999679,89999674,-5,5,-1,145
444,AgenteBasico,89999674,89999674,0,5,0,138
445,AgenteBasico,89999674,89999669,-5,5,-1,132
446,AgenteBasico,89999669,89999669,0,5,0,128
447,AgenteBasico,89999669,89999664,-5,5,-1,122
448,AgenteBasico,89999664,89999654,-10,40,-1,114
449,AgenteBasico,89999654,89999649,-5,5,-1,97
450,AgenteBasico,89999649,89999656,7,5,1,92
451,AgenteBasico,89999656,89999656,0,5,0,87
452,AgenteBasico,89999656,89999651,-5,5,-1,83
453,AgenteBasico,89999651,89999646,-5,5,-1,75
454,AgenteBasico,89999646,89999641,-5,5,-1,69
455,AgenteBasico,89999641,89999646,5,5,1,64
456,AgenteBasico,89999646,89999636,-10,10,-1,58
457,AgenteBasico,89999636,89999633,-3,0,-1,52
458,AgenteBasico,89999633,89999633,0,5,0,47
459,AgenteBasico,89999633,89999628,-5,5,-1,40
460,AgenteBasico,89999628,89999623,-5,5,-1,203
461,AgenteBasico,89999623,89999633,10,10,1,197
462,AgenteBasico,89999633,89999638,5,5,1,190
463,AgenteBasico,89999638,89999633,-5,5,-1,185
464,AgenteBasico,89999633,89999628,-5,5,-1,180
465,AgenteBasico,89999628,89999628,0,10,0,174
466,AgenteBasico,89999628,89999628,0,5,0,167
467,AgenteBasico,89999628,89999633,5,5,1,161
468,AgenteBasico,89999633,89999618,-15,15,-1,156
469,AgenteBasico,89999618,89999628,10,10,1,148
470,AgenteBasico,89999628,89999633,5,5,1,142
471,AgenteBasico,89999633,89999628,-5,5,-1,137
472,AgenteBasico,89999628,89999623,-5,5,-1,133
473,AgenteBasico,89999623,89999623,0,5,0,127
474,AgenteBasico,89999623,89999613,-10,10,-1,122
475,AgenteBasico,89999613,89999613,0,5,0,117
476,AgenteBasico,89999613,89999618,5,5,1,112
477,AgenteBasico,89999618,89999613,-5,5,-1,107
478,AgenteBasico,89999613,89999608,-5,5,-1,103
479,AgenteBasico,89999608,89999608,0,10,0,96
480,AgenteBasico,89999608,89999608,0,5,0,88
481,AgenteBasico,89999608,89999618,10,10,1,83
482,AgenteBasico,89999618,89999613,-5,5,-1,75
483,AgenteBasico,89999613,89999608,-5,5,-1,69
484,AgenteBasico,89999608,89999593,-15,15,-1,64
485,AgenteBasico,89999593,89999583,-10,10,-1,56
486,AgenteBasico,89999583,89999583,0,5,0,49
487,AgenteBasico,89999583,89999578,-5,5,-1,202
488,AgenteBasico,89999578,89999573,-5,5,-1,197
489,AgenteBasico,89999573,89999568,-5,5,-1,192
490,AgenteBasico,89999568,89999568,0,5,0,186
491,AgenteBasico,89999568,89999568,0,5,0,181
492,AgenteBasico,89999568,89999563,-5,5,-1,176
493,AgenteBasico,89999563,89999563,0,5,0,169
494,AgenteBasico,89999563,89999558,-5,5,-1,164
495,AgenteBasico,89999558,89999558,0,5,0,158
496,AgenteBasico,89999558,89999553,-5,5,-1,152
497,AgenteBasico,89999553,89999553,0,5,0,147
498,AgenteBasico,89999553,89999548,-5,10,-1,143
499,AgenteBasico,89999548,89999553,5,5,1,136
500,AgenteBasico,89999553,89999558,5,5,1,131
501,AgenteBasico,89999558,89999553,-5,5,-1,123
502,AgenteBasico,89999553,89999548,-5,5,-1,116
503,AgenteBasico,89999548,89999553,5,5,1,109
504,AgenteBasico,89999553,89999548,-5,5,-1,104
505,AgenteBasico,89999548,89999543,-5,5,-1,98
506,AgenteBasico,89999543,89999548,5,5,1,92
507,AgenteBasico,89999548,89999543,-5,5,-1,87
508,AgenteBasico,89999543,89999548,5,5,1,82
509,AgenteBasico,89999548,89999545,-3,0,-1,77
510,AgenteBasico,89999545,89999545,0,5,0,73
511,AgenteBasico,89999545,89999545,0,5,0,68
512,AgenteBasico,89999545,89999550,5,5,1,63
513,AgenteBasico,89999550,89999550,0,5,0,57
514,AgenteBasico,89999550,89999557,7,5,1,52
515,AgenteBasico,89999557,89999557,0,5,0,47
516,AgenteBasico,89999557,89999557,0,5,0,42
517,AgenteBasico,89999557,89999557,0,5,0,36
518,AgenteBasico,89999557,89999562,5,5,1,29
519,AgenteBasico,89999562,89999557,-5,5,-1,203
520,AgenteBasico,89999557,89999562,5,5,1,198
521,AgenteBasico,89999562,89999557,-5,5,-1,193
522,AgenteBasico,89999557,89999552,-5,5,-1,187
523,AgenteBasico,89999552,89999552,0,5,0,182
524,AgenteBasico,89999552,89999552,0,5,0,177
525,AgenteBasico,89999552,89999552,0,5,0,172
526,AgenteBasico,89999552,89999557,5,5,1,166
527,AgenteBasico,89999557,89999562,5,5,1,160
528,AgenteBasico,89999562,89999567,5,5,1,154
529,AgenteBasico,89999567,89999562,-5,5,-1,148
530,AgenteBasico,89999562,89999557,-5,5,-1,142
531,AgenteBasico,89999557,89999557,0,5,0,135
532,AgenteBasico,89999557,89999557,0,10,0,131
533,AgenteBasico,89999557,89999552,-5,5,-1,126
534,AgenteBasico,89999552,89999562,10,10,1,121
535,AgenteBasico,89999562,89999567,5,5,1,113
536,AgenteBasico,89999567,89999562,-5,5,-1,106
537,AgenteBasico,89999562,89999572,10,10,1,101
538,AgenteBasico,89999572,89999567,-5,5,-1,95
539,AgenteBasico,89999567,89999572,5,5,1,88
540,AgenteBasico,89999572,89999577,5,5,1,81
541,AgenteBasico,89999577,89999577,0,5,0,76
542,AgenteBasico,89999577,89999582,5,5,1,71
543,AgenteBasico,89999582,89999587,5,5,1,66
544,AgenteBasico,89999587,89999592,5,5,1,59
545,AgenteBasico,89999592,89999597,5,5,1,54
546,AgenteBasico,89999597,89999592,-5,5,-1,49
547,AgenteBasico,89999592,89999592,0,5,0,42
548,AgenteBasico,89999592,89999597,5,5,1,38
549,AgenteBasico,89999597,89999604,7,5,1,33
550,AgenteBasico,89999604,89999609,5,5,1,203
551,AgenteBasico,89999609,89999604,-5,5,-1,197
552,AgenteBasico,89999604,89999599,-5,5,-1,192
553,AgenteBasico,89999599,89999594,-5,5,-1,186
554,AgenteBasico,89999594,89999599,5,5,1,181
555,AgenteBasico,89999599,89999594,-5,5,-1,176
556,AgenteBasico,89999594,89999599,5,5,1,171
557,AgenteBasico,89999599,89999599,0,5,0,165
558,AgenteBasico,89999599,89999604,5,5,1,161
559,AgenteBasico,89999604,89999604,0,5,0,156
560,AgenteBasico,89999604,89999599,-5,5,-1,151
561,AgenteBasico,89999599,89999594,-5,5,-1,146
562,AgenteBasico,89999594,89999599,5,5,1,141
563,AgenteBasico,89999599,89999594,-5,5,-1,134
564,AgenteBasico,89999594,89999599,5,5,1,129
565,AgenteBasico,89999599,89999599,0,5,0,123
566,AgenteBasico,89999599,89999594,-5,5,-1,119
567,AgenteBasico,89999594,89999589,-5,5,-1,113
568,AgenteBasico,89999589,89999599,10,10,1,108
569,AgenteBasico,89999599,89999594,-5,5,-1,102
570,AgenteBasico,89999594,89999601,7,5,1,97
571,AgenteBasico,89999601,89999606,5,5,1,93
572,AgenteBasico,89999606,89999601,-5,5,-1,88
573,AgenteBasico,89999601,89999591,-10,10,-1,83
574,AgenteBasico,89999591,89999586,-5,25,-1,78
575,AgenteBasico,89999586,89999586,0,10,0,68
576,AgenteBasico,89999586,89999596,10,10,1,63
577,AgenteBasico,89999596,89999601,5,5,1,56
578,AgenteBasico,89999601,89999606,5,5,1,50
579,AgenteBasico,89999606,89999613,7,5,1,44
580,AgenteBasico,89999613,89999608,-5,5,-1,204
581,AgenteBasico,89999608,89999603,-5,5,-1,196
582,AgenteBasico,89999603,89999598,-5,15,-1,189
583,AgenteBasico,89999598,89999593,-5,5,-1,181
584,AgenteBasico,89999593,89999588,-5,5,-1,175
585,AgenteBasico,89999588,89999583,-5,5,-1,170
586,AgenteBasico,89999583,89999588,5,5,1,165
587,AgenteBasico,89999588,89999583,-5,5,-1,160
588,AgenteBasico,89999583,89999578,-5,5,-1,154
589,AgenteBasico,89999578,89999578,0,5,0,149
590,AgenteBasico,89999578,89999575,-3,0,-1,143
591,AgenteBasico,89999575,89999585,10,10,1,139
592,AgenteBasico,89999585,89999580,-5,5,-1,133
593,AgenteBasico,89999580,89999590,10,10,1,128
594,AgenteBasico,89999590,89999590,0,5,0,120
595,AgenteBasico,89999590,89999585,-5,5,-1,116
596,AgenteBasico,89999585,89999580,-5,5,-1,110
597,AgenteBasico,89999580,89999577,-3,0,-1,104
598,AgenteBasico,89999577,89999572,-5,5,-1,99
599,AgenteBasico,89999572,89999579,7,5,1,92
600,AgenteBasico,89999579,89999584,5,5,1,87
601,AgenteBasico,89999584,89999579,-5,5,-1,82
602,AgenteBasico,89999579,89999579,0,5,0,77
603,AgenteBasico,89999579,89999579,0,5,0,73
604,AgenteBasico,89999579,89999574,-5,5,-1,69
605,AgenteBasico,89999574,89999571,-3,0,-1,59
606,AgenteBasico,89999571,89999576,5,5,1,53
607,AgenteBasico,89999576,89999571,-5,5,-1,47
608,AgenteBasico,89999571,89999571,0,5,0,41
609,AgenteBasico,89999571,89999566,-5,5,-1,203
610,AgenteBasico,89999566,89999566,0,5,0,198
611,AgenteBasico,89999566,89999561,-5,5,-1,192
612,AgenteBasico,89999561,89999571,10,10,1,186
613,AgenteBasico,89999571,89999576,5,5,1,179
614,AgenteBasico,89999576,89999581,5,5,1,174
615,AgenteBasico,89999581,89999578,-3,0,-1,169
616,AgenteBasico,89999578,89999583,5,5,1,165
617,AgenteBasico,89999583,89999583,0,5,0,158
618,AgenteBasico,89999583,89999588,5,5,1,152
619,AgenteBasico,89999588,89999593,5,5,1,146
620,AgenteBasico,89999593,89999593,0,10,0,141
621,AgenteBasico,89999593,89999593,0,5,0,135
622,AgenteBasico,89999593,89999588,-5,5,-1,130
623,AgenteBasico,89999588,89999588,0,5,0,125
624,AgenteBasico,89999588,89999598,10,10,1,119
625,AgenteBasico,89999598,89999593,-5,5,-1,113
626,AgenteBasico,89999593,89999588,-5,5,-1,107
627,AgenteBasico,89999588,89999593,5,5,1,102
628,AgenteBasico,89999593,89999593,0,5,0,95
629,AgenteBasico,89999593,89999588,-5,5,-1,91
630,AgenteBasico,89999588,89999603,15,15,1,85
631,AgenteBasico,89999603,89999603,0,5,0,74
632,AgenteBasico,89999603,89999598,-5,5,-1,70
633,AgenteBasico,89999598,89999598,0,5,0,64
634,AgenteBasico,89999598,89999593,-5,5,-1,60
635,AgenteBasico,89999593,89999588,-5,5,-1,53
636,AgenteBasico,89999588,89999598,10,10,1,48
637,AgenteBasico,89999598,89999603,5,5,1,41
638,AgenteBasico,89999603,89999608,5,5,1,35
639,AgenteBasico,89999608,89999613,5,5,1,29
640,AgenteBasico,89999613,89999618,5,5,1,201
641,AgenteBasico,89999618,89999623,5,5,1,196
642,AgenteBasico,89999623,89999623,0,5,0,191
643,AgenteBasico,89999623,89999620,-3,0,-1,185
644,AgenteBasico,89999620,89999625,5,5,1,180
645,AgenteBasico,89999625,89999625,0,5,0,174
646,AgenteBasico,89999625,89999620,-5,5,-1,168
647,AgenteBasico,89999620,89999620,0,5,0,163
648,AgenteBasico,89999620,89999635,15,15,1,159
649,AgenteBasico,89999635,89999635,0,5,0,148
650,AgenteBasico,89999635,89999640,5,5,1,143
651,AgenteBasico,89999640,89999640,0,5,0,137
652,AgenteBasico,89999640,89999645,5,5,1,132
653,AgenteBasico,89999645,89999640,-5,5,-1,127
654,AgenteBasico,89999640,89999635,-5,5,-1,121
655,AgenteBasico,89999635,89999645,10,10,1,115
656,AgenteBasico,89999645,89999650,5,5,1,109
657,AgenteBasico,89999650,89999647,-3,0,-1,103
658,AgenteBasico,89999647,89999652,5,5,1,99
659,AgenteBasico,89999652,89999647,-5,5,-1,93
660,AgenteBasico,89999647,89999652,5,5,1,88
661,AgenteBasico,89999652,89999647,-5,5,-1,82
662,AgenteBasico,89999647,89999647,0,5,0,77
663,AgenteBasico,89999647,89999657,10,10,1,72
664,AgenteBasico,89999657,89999657,0,5,0,65
665,AgenteBasico,89999657,89999662,5,5,1,61
666,AgenteBasico,89999662,89999652,-10,10,-1,56
667,AgenteBasico,89999652,89999647,-5,5,-1,49
668,AgenteBasico,89999647,89999647,0,5,0,44
669,AgenteBasico,89999647,89999652,5,5,1,37
670,AgenteBasico,89999652,89999647,-5,5,-1,202
671,AgenteBasico,89999647,89999642,-5,5,-1,196
672,AgenteBasico,89999642,89999637,-5,5,-1,188
673,AgenteBasico,89999637,89999642,5,5,1,183
674,AgenteBasico,89999642,89999647,5,5,1,176
675,AgenteBasico,89999647,89999637,-10,10,-1,170
676,AgenteBasico,89999637,89999642,5,5,1,164
677,AgenteBasico,89999642,89999642,0,5,0,158
678,AgenteBasico,89999642,89999637,-5,5,-1,153
679,AgenteBasico,89999637,89999632,-5,5,-1,147
680,AgenteBasico,89999632,89999637,5,5,1,141
681,AgenteBasico,89999637,89999632,-5,5,-1,136
682,AgenteBasico,89999632,89999627,-5,5,-1,131
683,AgenteBasico,89999627,89999632,5,5,1,126
684,AgenteBasico,89999632,89999632,0,5,0,121
685,AgenteBasico,89999632,89999632,0,5,0,117
686,AgenteBasico,89999632,89999632,0,10,0,112
687,AgenteBasico,89999632,89999627,-5,5,-1,107
688,AgenteBasico,89999627,89999637,10,10,1,101
689,AgenteBasico,89999637,89999632,-5,5,-1,94
690,AgenteBasico,89999632,89999632,0,5,0,90
691,AgenteBasico,89999632,89999629,-3,0,-1,85
692,AgenteBasico,89999629,89999624,-5,5,-1,81
693,AgenteBasico,89999624,89999619,-5,5,-1,76
694,AgenteBasico,89999619,89999614,-5,5,-1,70
695,AgenteBasico,89999614,89999619,5,5,1,65
696,AgenteBasico,89999619,89999626,7,5,1,58
697,AgenteBasico,89999626,89999631,5,5,1,53
698,AgenteBasico,89999631,89999636,5,5,1,46
699,AgenteBasico,89999636,89999641,5,5,1,200
700,AgenteBasico,89999641,89999636,-5,5,-1,194
701,AgenteBasico,89999636,89999631,-5,5,-1,189
702,AgenteBasico,89999631,89999636,5,5,1,183
703,AgenteBasico,89999636,89999631,-5,5,-1,177
704,AgenteBasico,89999631,89999626,-5,5,-1,173
705,AgenteBasico,89999626,89999626,0,5,0,168
706,AgenteBasico,89999626,89999631,5,5,1,163
707,AgenteBasico,89999631,89999636,5,5,1,158
708,AgenteBasico,89999636,89999641,5,5,1,152
709,AgenteBasico,89999641,89999631,-10,10,-1,145
710,AgenteBasico,89999631,89999626,-5,5,-1,139
711,AgenteBasico,89999626,89999621,-5,5,-1,134
712,AgenteBasico,89999621,89999621,0,5,0,130
713,AgenteBasico,89999621,89999626,5,5,1,125
714,AgenteBasico,89999626,89999623,-3,0,-1,120
715,AgenteBasico,89999623,89999623,0,10,0,116
716,AgenteBasico,89999623,89999623,0,5,0,111
717,AgenteBasico,89999623,89999618,-5,5,-1,106
718,AgenteBasico,89999618,89999623,5,5,1,100
719,AgenteBasico,89999623,89999618,-5,5,-1,93
720,AgenteBasico,89999618,89999615,-3,0,-1,87
721,AgenteBasico,89999615,89999620,5,5,1,83
722,AgenteBasico,89999620,89999615,-5,5,-1,76
723,AgenteBasico,89999615,89999610,-5,5,-1,70
724,AgenteBasico,89999610,89999615,5,5,1,64
725,AgenteBasico,89999615,89999615,0,10,0,58
726,AgenteBasico,89999615,89999605,-10,10,-1,50
727,AgenteBasico,89999605,89999600,-5,5,-1,44
728,AgenteBasico,89999600,89999590,-10,10,-1,203
729,AgenteBasico,89999590,89999585,-5,5,-1,197
730,AgenteBasico,89999585,89999592,7,5,1,192
731,AgenteBasico,89999592,89999582,-10,10,-1,187
732,AgenteBasico,89999582,89999587,5,5,1,182
733,AgenteBasico,89999587,89999584,-3,0,-1,176
734,AgenteBasico,89999584,89999579,-5,5,-1,172
735,AgenteBasico,89999579,89999579,0,5,0,167
736,AgenteBasico,89999579,89999579,0,10,0,161
737,AgenteBasico,89999579,89999574,-5,5,-1,156
738,AgenteBasico,89999574,89999579,5,5,1,150
739,AgenteBasico,89999579,89999584,5,5,1,144
740,AgenteBasico,89999584,89999579,-5,5,-1,139
741,AgenteBasico,89999579,89999579,0,5,0,134
742,AgenteBasico,89999579,89999579,0,5,0,124
743,AgenteBasico,89999579,89999599,20,20,1,119
744,AgenteBasico,89999599,89999594,-5,5,-1,109
745,AgenteBasico,89999594,89999589,-5,5,-1,102
746,AgenteBasico,89999589,89999584,-5,5,-1,97
747,AgenteBasico,89999584,89999579,-5,5,-1,92
748,AgenteBasico,89999579,89999584,5,5,1,85
749,AgenteBasico,89999584,89999584,0,5,0,79
750,AgenteBasico,89999584,89999591,7,5,1,74
751,AgenteBasico,89999591,89999591,0,5,0,69
752,AgenteBasico,89999591,89999591,0,5,0,63
753,AgenteBasico,89999591,89999591,0,5,0,58
754,AgenteBasico,89999591,89999596,5,5,1,54
755,AgenteBasico,89999596,89999601,5,5,1,48
756,AgenteBasico,89999601,89999601,0,5,0,203
757,AgenteBasico,89999601,89999596,-5,5,-1,199
758,AgenteBasico,89999596,89999593,-3,0,-1,195
759,AgenteBasico,89999593,89999588,-5,5,-1,190
760,AgenteBasico,89999588,89999588,0,5,0,185
761,AgenteBasico,89999588,89999583,-5,5,-1,180
762,AgenteBasico,89999583,89999578,-5,5,-1,175
763,AgenteBasico,89999578,89999578,0,5,0,169
764,AgenteBasico,89999578,89999588,10,10,1,164
765,AgenteBasico,89999588,89999588,0,5,0,158
766,AgenteBasico,89999588,89999593,5,5,1,154
767,AgenteBasico,89999593,89999588,-5,5,-1,146
768,AgenteBasico,89999588,89999583,-5,5,-1,139
769,AgenteBasico,89999583,89999578,-5,5,-1,134
770,AgenteBasico,89999578,89999568,-10,10,-1,128
771,AgenteBasico,89999568,89999565,-3,0,-1,120
772,AgenteBasico,89999565,89999560,-5,5,-1,116
773,AgenteBasico,89999560,89999560,0,5,0,109
774,AgenteBasico,89999560,89999560,0,5,0,104
775,AgenteBasico,89999560,89999555,-5,5,-1,95
776,AgenteBasico,89999555,89999560,5,5,1,90
777,AgenteBasico,89999560,89999555,-5,15,-1,85
778,AgenteBasico,89999555,89999550,-5,5,-1,75
779,AgenteBasico,89999550,89999555,5,5,1,70
780,AgenteBasico,89999555,89999555,0,5,0,65
781,AgenteBasico,89999555,89999550,-5,5,-1,60
782,AgenteBasico,89999550,89999555,5,5,1,51
783,AgenteBasico,89999555,89999550,-5,5,-1,46
784,AgenteBasico,89999550,89999555,5,5,1,40
785,AgenteBasico,89999555,89999560,5,5,1,35
786,AgenteBasico,89999560,89999555,-5,5,-1,202
787,AgenteBasico,89999555,89999550,-5,5,-1,196
788,AgenteBasico,89999550,89999555,5,5,1,190
789,AgenteBasico,89999555,89999550,-5,5,-1,184
790,AgenteBasico,89999550,89999555,5,5,1,179
791,AgenteBasico,89999555,89999562,7,5,1,173
792,AgenteBasico,89999562,89999567,5,5,1,168
793,AgenteBasico,89999567,89999572,5,5,1,162
794,AgenteBasico,89999572,89999572,0,5,0,157
795,AgenteBasico,89999572,89999572,0,5,0,152
796,AgenteBasico,89999572,89999577,5,5,1,148
797,AgenteBasico,89999577,89999577,0,5,0,143
798,AgenteBasico,89999577,89999572,-5,5,-1,139
799,AgenteBasico,89999572,89999572,0,5,0,134
800,AgenteBasico,89999572,89999577,5,5,1,129
801,AgenteBasico,89999577,89999582,5,5,1,124
802,AgenteBasico,89999582,89999577,-5,5,-1,119
803,AgenteBasico,89999577,89999572,-5,5,-1,112
804,AgenteBasico,89999572,89999577,5,5,1,107
805,AgenteBasico,89999577,89999577,0,5,0,101
806,AgenteBasico,89999577,89999572,-5,5,-1,93
807,AgenteBasico,89999572,89999582,10,10,1,85
808,AgenteBasico,89999582,89999587,5,5,1,79
809,AgenteBasico,89999587,89999592,5,5,1,72
810,AgenteBasico,89999592,89999587,-5,5,-1,67
811,AgenteBasico,89999587,89999582,-5,5,-1,60
812,AgenteBasico,89999582,89999577,-5,5,-1,53
813,AgenteBasico,89999577,89999572,-5,5,-1,47
814,AgenteBasico,89999572,89999579,7,5,1,42
815,AgenteBasico,89999579,89999584,5,5,1,203
816,AgenteBasico,89999584,89999591,7,5,1,198
817,AgenteBasico,89999591,89999596,5,5,1,194
818,AgenteBasico,89999596,89999603,7,5,1,187
819,AgenteBasico,89999603,89999598,-5,5,-1,181
820,AgenteBasico,89999598,89999603,5,5,1,176
821,AgenteBasico,89999603,89999608,5,5,1,171
822,AgenteBasico,89999608,89999603,-5,5,-1,166
823,AgenteBasico,89999603,89999600,-3,0,-1,160
824,AgenteBasico,89999600,89999600,0,5,0,155
825,AgenteBasico,89999600,89999600,0,10,0,149
826,AgenteBasico,89999600,89999595,-5,5,-1,143
827,AgenteBasico,89999595,89999590,-5,5,-1,136
828,AgenteBasico,89999590,89999585,-5,5,-1,130
829,AgenteBasico,89999585,89999585,0,5,0,124
830,AgenteBasico,89999585,89999575,-10,10,-1,119
831,AgenteBasico,89999575,89999575,0,5,0,111
832,AgenteBasico,89999575,89999575,0,10,0,107
833,AgenteBasico,89999575,89999570,-5,5,-1,101
834,AgenteBasico,89999570,89999577,7,5,1,94
835,AgenteBasico,89999577,89999572,-5,5,-1,88
836,AgenteBasico,89999572,89999572,0,5,0,83
837,AgenteBasico,89999572,89999572,0,5,0,78
838,AgenteBasico,89999572,89999582,10,10,1,73
839,AgenteBasico,89999582,89999582,0,5,0,62
840,AgenteBasico,89999582,89999577,-5,5,-1,58
841,AgenteBasico,89999577,89999582,5,5,1,52
842,AgenteBasico,89999582,89999587,5,5,1,47
843,AgenteBasico,89999587,89999582,-5,5,-1,40
844,AgenteBasico,89999582,89999577,-5,5,-1,202
845,AgenteBasico,89999577,89999567,-10,10,-1,196
846,AgenteBasico,89999567,89999567,0,5,0,190
847,AgenteBasico,89999567,89999562,-5,5,-1,186
848,AgenteBasico,89999562,89999562,0,5,0,180
849,AgenteBasico,89999562,89999567,5,5,1,176
850,AgenteBasico,89999567,89999572,5,5,1,170
851,AgenteBasico,89999572,89999562,-10,10,-1,164
852,AgenteBasico,89999562,89999562,0,5,0,158
853,AgenteBasico,89999562,89999567,5,5,1,154
854,AgenteBasico,89999567,89999567,0,5,0,148
855,AgenteBasico,89999567,89999567,0,5,0,142
856,AgenteBasico,89999567,89999562,-5,5,-1,137
857,AgenteBasico,89999562,89999557,-5,5,-1,132
858,AgenteBasico,89999557,89999562,5,5,1,126
859,AgenteBasico,89999562,89999569,7,5,1,121
860,AgenteBasico,89999569,89999569,0,10,0,116
861,AgenteBasico,89999569,89999579,10,10,1,110
862,AgenteBasico,89999579,89999589,10,10,1,104
863,AgenteBasico,89999589,89999594,5,5,1,98
864,AgenteBasico,89999594,89999601,7,5,1,92
865,AgenteBasico,89999601,89999601,0,5,0,88
866,AgenteBasico,89999601,89999596,-5,5,-1,83
867,AgenteBasico,89999596,89999603,7,5,1,77
868,AgenteBasico,89999603,89999603,0,5,0,72
869,AgenteBasico,89999603,89999598,-5,5,-1,66
870,AgenteBasico,89999598,89999598,0,5,0,61
871,AgenteBasico,89999598,89999595,-3,0,-1,56
872,AgenteBasico,89999595,89999605,10,10,1,51
873,AgenteBasico,89999605,89999610,5,5,1,45
874,AgenteBasico,89999610,89999610,0,5,0,38
875,AgenteBasico,89999610,89999610,0,5,0,34
876,AgenteBasico,89999610,89999610,0,5,0,201
877,AgenteBasico,89999610,89999605,-5,5,-1,197
878,AgenteBasico,89999605,89999600,-5,5,-1,193
879,AgenteBasico,89999600,89999595,-5,5,-1,187
880,AgenteBasico,89999595,89999585,-10,10,-1,180
881,AgenteBasico,89999585,89999590,5,5,1,173
882,AgenteBasico,89999590,89999590,0,5,0,168
883,AgenteBasico,89999590,89999595,5,5,1,162
884,AgenteBasico,89999595,89999590,-5,5,-1,155
885,AgenteBasico,89999590,89999595,5,5,1,150
886,AgenteBasico,89999595,89999600,5,5,1,144
887,AgenteBasico,89999600,89999600,0,10,0,137
888,AgenteBasico,89999600,89999600,0,5,0,132
889,AgenteBasico,89999600,89999595,-5,5,-1,125
890,AgenteBasico,89999595,89999600,5,5,1,119
891,AgenteBasico,89999600,89999595,-5,5,-1,113
892,AgenteBasico,89999595,89999590,-5,5,-1,107
893,AgenteBasico,89999590,89999595,5,5,1,101
894,AgenteBasico,89999595,89999590,-5,5,-1,95
895,AgenteBasico,89999590,89999590,0,5,0,89
896,AgenteBasico,89999590,89999585,-5,5,-1,85
897,AgenteBasico,89999585,89999590,5,5,1,80
898,AgenteBasico,89999590,89999585,-5,5,-1,74
899,AgenteBasico,89999585,89999585,0,10,0,68
900,AgenteBasico,89999585,89999585,0,5,0,60
901,AgenteBasico,89999585,89999580,-5,5,-1,55
902,AgenteBasico,89999580,89999570,-10,10,-1,49
903,AgenteBasico,89999570,89999565,-5,5,-1,43
904,AgenteBasico,89999565,89999560,-5,5,-1,38
905,AgenteBasico,89999560,89999560,0,5,0,201
906,AgenteBasico,89999560,89999555,-5,5,-1,196
907,AgenteBasico,89999555,89999552,-3,0,-1,190
908,AgenteBasico,89999552,89999552,0,10,0,185
909,AgenteBasico,89999552,89999549,-3,0,-1,180
910,AgenteBasico,89999549,89999546,-3,0,-1,176
911,AgenteBasico,89999546,89999551,5,5,1,171
912,AgenteBasico,89999551,89999546,-5,5,-1,164
913,AgenteBasico,89999546,89999541,-5,5,-1,159
914,AgenteBasico,89999541,89999546,5,5,1,154
915,AgenteBasico,89999546,89999541,-5,5,-1,149
916,AgenteBasico,89999541,89999536,-5,5,-1,143
917,AgenteBasico,89999536,89999541,5,5,1,138
918,AgenteBasico,89999541,89999541,0,5,0,133
919,AgenteBasico,89999541,89999536,-5,5,-1,129
920,AgenteBasico,89999536,89999531,-5,5,-1,124
921,AgenteBasico,89999531,89999526,-5,5,-1,118
922,AgenteBasico,89999526,89999521,-5,5,-1,113
923,AgenteBasico,89999521,89999526,5,5,1,108
924,AgenteBasico,89999526,89999521,-5,5,-1,103
925,AgenteBasico,89999521,89999521,0,5,0,97
926,AgenteBasico,89999521,89999516,-5,5,-1,92
927,AgenteBasico,89999516,89999511,-5,5,-1,87
928,AgenteBasico,89999511,89999506,-5,5,-1,82
929,AgenteBasico,89999506,89999501,-5,5,-1,77
930,AgenteBasico,89999501,89999486,-15,15,-1,71
931,AgenteBasico,89999486,89999491,5,5,1,63
932,AgenteBasico,89999491,89999491,0,5,0,56
933,AgenteBasico,89999491,89999486,-5,5,-1,50
934,AgenteBasico,89999486,89999486,0,5,0,45
935,AgenteBasico,89999486,89999476,-10,10,-1,40
936,AgenteBasico,89999476,89999471,-5,5,-1,35
937,AgenteBasico,89999471,89999466,-5,5,-1,29
938,AgenteBasico,89999466,89999466,0,5,0,202
939,AgenteBasico,89999466,89999461,-5,5,-1,197
940,AgenteBasico,89999461,89999456,-5,5,-1,192
941,AgenteBasico,89999456,89999461,5,5,1,188
942,AgenteBasico,89999461,89999456,-5,5,-1,183
943,AgenteBasico,89999456,89999456,0,5,0,178
944,AgenteBasico,89999456,89999461,5,5,1,173
945,AgenteBasico,89999461,89999456,-5,5,-1,167
946,AgenteBasico,89999456,89999451,-5,5,-1,163
947,AgenteBasico,89999451,89999446,-5,5,-1,157
948,AgenteBasico,89999446,89999441,-5,5,-1,151
949,AgenteBasico,89999441,89999441,0,5,0,145
950,AgenteBasico,89999441,89999438,-3,0,-1,139
951,AgenteBasico,89999438,89999438,0,10,0,135
952,AgenteBasico,89999438,89999448,10,10,1,129
953,AgenteBasico,89999448,89999438,-10,10,-1,123
954,AgenteBasico,89999438,89999443,5,5,1,116
955,AgenteBasico,89999443,89999438,-5,5,-1,111
956,AgenteBasico,89999438,89999438,0,5,0,107
957,AgenteBasico,89999438,89999435,-3,0,-1,103
958,AgenteBasico,89999435,89999440,5,5,1,98
959,AgenteBasico,89999440,89999440,0,5,0,89
960,AgenteBasico,89999440,89999440,0,5,0,82
961,AgenteBasico,89999440,89999445,5,5,1,76
962,AgenteBasico,89999445,89999440,-5,5,-1,71
963,AgenteBasico,89999440,89999445,5,5,1,66
964,AgenteBasico,89999445,89999440,-5,5,-1,60
965,AgenteBasico,89999440,89999435,-5,5,-1,56
966,AgenteBasico,89999435,89999430,-5,5,-1,49
967,AgenteBasico,89999430,89999430,0,5,0,43
968,AgenteBasico,89999430,89999425,-5,5,-1,36
969,AgenteBasico,89999425,89999425,0,5,0,203
970,AgenteBasico,89999425,89999430,5,5,1,199
971,AgenteBasico,89999430,89999430,0,5,0,193
972,AgenteBasico,89999430,89999430,0,5,0,187
973,AgenteBasico,89999430,89999425,-5,5,-1,182
974,AgenteBasico,89999425,89999430,5,5,1,177
975,AgenteBasico,89999430,89999425,-5,5,-1,172
976,AgenteBasico,89999425,89999420,-5,5,-1,168
977,AgenteBasico,89999420,89999425,5,5,1,162
978,AgenteBasico,89999425,89999430,5,5,1,156
979,AgenteBasico,89999430,89999425,-5,5,-1,150
980,AgenteBasico,89999425,89999430,5,5,1,143
981,AgenteBasico,89999430,89999425,-5,5,-1,137
982,AgenteBasico,89999425,89999422,-3,0,-1,131
983,AgenteBasico,89999422,89999429,7,5,1,126
984,AgenteBasico,89999429,89999436,7,5,1,122
985,AgenteBasico,89999436,89999431,-5,5,-1,117
986,AgenteBasico,89999431,89999436,5,5,1,112
987,AgenteBasico,89999436,89999441,5,5,1,106
988,AgenteBasico,89999441,89999446,5,5,1,98
989,AgenteBasico,89999446,89999456,10,10,1,89
990,AgenteBasico,89999456,89999461,5,5,1,83
991,AgenteBasico,89999461,89999456,-5,5,-1,76
992,AgenteBasico,89999456,89999451,-5,5,-1,69
993,AgenteBasico,89999451,89999451,0,5,0,61
994,AgenteBasico,89999451,89999456,5,5,1,56
995,AgenteBasico,89999456,89999446,-10,10,-1,51
996,AgenteBasico,89999446,89999441,-5,5,-1,202
997,AgenteBasico,89999441,89999438,-3,0,-1,197
998,AgenteBasico,89999438,89999435,-3,0,-1,192
999,AgenteBasico,89999435,89999430,-5,5,-1,188
1000,AgenteBasico,89999430,89999427,-3,0,-1,183
1001,AgenteBasico,89999427,89999427,0,5,0,179
1002,AgenteBasico,89999427,89999434,7,5,1,175
1003,AgenteBasico,89999434,89999434,0,5,0,170
1004,AgenteBasico,89999434,89999429,-5,5,-1,164
1005,AgenteBasico,89999429,89999424,-5,5,-1,158
1006,AgenteBasico,89999424,89999419,-5,5,-1,153
1007,AgenteBasico,89999419,89999409,-10,10,-1,149
1008,AgenteBasico,89999409,89999404,-5,5,-1,143
1009,AgenteBasico,89999404,89999404,0,5,0,137
1010,AgenteBasico,89999404,89999399,-5,5,-1,132
1011,AgenteBasico,89999399,89999406,7,5,1,127
1012,AgenteBasico,89999406,89999406,0,5,0,123
1013,AgenteBasico,89999406,89999401,-5,5,-1,117
1014,AgenteBasico,89999401,89999396,-5,5,-1,110
1015,AgenteBasico,89999396,89999396,0,5,0,104
1016,AgenteBasico,89999396,89999391,-5,5,-1,99
1017,AgenteBasico,89999391,89999391,0,10,0,94
1018,AgenteBasico,89999391,89999391,0,5,0,87
1019,AgenteBasico,89999391,89999396,5,5,1,81
1020,AgenteBasico,89999396,89999396,0,5,0,73
1021,AgenteBasico,89999396,89999403,7,5,1,67
1022,AgenteBasico,89999403,89999398,-5,5,-1,63
1023,AgenteBasico,89999398,89999398,0,5,0,57
1024,AgenteBasico,89999398,89999393,-5,5,-1,52
1025,AgenteBasico,89999393,89999398,5,5,1,46
1026,AgenteBasico,89999398,89999405,7,5,1,40
1027,AgenteBasico,89999405,89999400,-5,5,-1,204
1028,AgenteBasico,89999400,89999395,-5,5,-1,198
1029,AgenteBasico,89999395,89999390,-5,5,-1,193
1030,AgenteBasico,89999390,89999395,5,5,1,187
1031,AgenteBasico,89999395,89999402,7,5,1,181
1032,AgenteBasico,89999402,89999397,-5,5,-1,177
1033,AgenteBasico,89999397,89999392,-5,5,-1,170
1034,AgenteBasico,89999392,89999392,0,5,0,164
1035,AgenteBasico,89999392,89999397,5,5,1,160
1036,AgenteBasico,89999397,89999392,-5,5,-1,152
1037,AgenteBasico,89999392,89999387,-5,5,-1,148
1038,AgenteBasico,89999387,89999377,-10,10,-1,141
1039,AgenteBasico,89999377,89999377,0,5,0,135
1040,AgenteBasico,89999377,89999372,-5,5,-1,131
1041,AgenteBasico,89999372,89999379,7,5,1,127
1042,AgenteBasico,89999379,89999379,0,5,0,121
1043,AgenteBasico,89999379,89999374,-5,5,-1,115
1044,AgenteBasico,89999374,89999369,-5,5,-1,111
1045,AgenteBasico,89999369,89999376,7,5,1,106
1046,AgenteBasico,89999376,89999373,-3,0,-1,102
1047,AgenteBasico,89999373,89999373,0,5,0,98
1048,AgenteBasico,89999373,89999363,-10,10,-1,93
1049,AgenteBasico,89999363,89999353,-10,20,-1,87
1050,AgenteBasico,89999353,89999363,10,10,1,78
1051,AgenteBasico,89999363,89999370,7,5,1,72
1052,AgenteBasico,89999370,89999360,-10,10,-1,68
1053,AgenteBasico,89999360,89999350,-10,10,-1,63
1054,AgenteBasico,89999350,89999335,-15,15,-1,56
1055,AgenteBasico,89999335,89999340,5,5,1,46
1056,AgenteBasico,89999340,89999337,-3,0,-1,41
1057,AgenteBasico,89999337,89999332,-5,5,-1,37
1058,AgenteBasico,89999332,89999327,-5,5,-1,31
1059,AgenteBasico,89999327,89999322,-5,5,-1,203
1060,AgenteBasico,89999322,89999329,7,5,1,196
1061,AgenteBasico,89999329,89999329,0,5,0,192
1062,AgenteBasico,89999329,89999329,0,5,0,186
1063,AgenteBasico,89999329,89999334,5,5,1,181
1064,AgenteBasico,89999334,89999334,0,5,0,173
1065,AgenteBasico,89999334,89999339,5,5,1,168
1066,AgenteBasico,89999339,89999334,-5,5,-1,163
1067,AgenteBasico,89999334,89999339,5,5,1,158
1068,AgenteBasico,89999339,89999334,-5,5,-1,153
1069,AgenteBasico,89999334,89999329,-5,5,-1,146
1070,AgenteBasico,89999329,89999324,-5,5,-1,140
1071,AgenteBasico,89999324,89999314,-10,10,-1,136
1072,AgenteBasico,89999314,89999309,-5,5,-1,130
1073,AgenteBasico,89999309,89999309,0,5,0,125
1074,AgenteBasico,89999309,89999304,-5,5,-1,119
1075,AgenteBasico,89999304,89999309,5,5,1,113
1076,AgenteBasico,89999309,89999309,0,5,0,108
1077,AgenteBasico,89999309,89999309,0,5,0,101
1078,AgenteBasico,89999309,89999304,-5,5,-1,97
1079,AgenteBasico,89999304,89999299,-5,5,-1,92
1080,AgenteBasico,89999299,89999306,7,5,1,86
1081,AgenteBasico,89999306,89999306,0,5,0,80
1082,AgenteBasico,89999306,89999301,-5,5,-1,74
1083,AgenteBasico,89999301,89999301,0,10,0,68
1084,AgenteBasico,89999301,89999296,-5,5,-1,61
1085,AgenteBasico,89999296,89999296,0,5,0,56
1086,AgenteBasico,89999296,89999306,10,10,1,52
1087,AgenteBasico,89999306,89999306,0,5,0,202
1088,AgenteBasico,89999306,89999311,5,5,1,197
1089,AgenteBasico,89999311,89999311,0,5,0,190
1090,AgenteBasico,89999311,89999306,-5,5,-1,184
1091,AgenteBasico,89999306,89999301,-5,5,-1,178
1092,AgenteBasico,89999301,89999296,-5,5,-1,173
1093,AgenteBasico,89999296,89999296,0,5,0,168
1094,AgenteBasico,89999296,89999291,-5,5,-1,162
1095,AgenteBasico,89999291,89999296,5,5,1,157
1096,AgenteBasico,89999296,89999296,0,5,0,150
1097,AgenteBasico,89999296,89999296,0,10,0,144
1098,AgenteBasico,89999296,89999303,7,5,1,138
1099,AgenteBasico,89999303,89999303,0,5,0,134
1100,AgenteBasico,89999303,89999310,7,5,1,129
1101,AgenteBasico,89999310,89999305,-5,5,-1,125
1102,AgenteBasico,89999305,89999305,0,5,0,119
1103,AgenteBasico,89999305,89999312,7,5,1,111
1104,AgenteBasico,89999312,89999302,-10,10,-1,106
1105,AgenteBasico,89999302,89999297,-5,5,-1,100
1106,AgenteBasico,89999297,89999292,-5,5,-1,95
1107,AgenteBasico,89999292,89999287,-5,5,-1,90
1108,AgenteBasico,89999287,89999292,5,5,1,84
1109,AgenteBasico,89999292,89999287,-5,5,-1,79
1110,AgenteBasico,89999287,89999277,-10,10,-1,74
1111,AgenteBasico,89999277,89999274,-3,0,-1,69
1112,AgenteBasico,89999274,89999279,5,5,1,65
1113,AgenteBasico,89999279,89999269,-10,10,-1,59
1114,AgenteBasico,89999269,89999264,-5,5,-1,52
1115,AgenteBasico,89999264,89999259,-5,5,-1,47
1116,AgenteBasico,89999259,89999264,5,5,1,42
1117,AgenteBasico,89999264,89999269,5,5,1,36
1118,AgenteBasico,89999269,89999269,0,10,0,30
1119,AgenteBasico,89999269,89999279,10,10,1,202
1120,AgenteBasico,89999279,89999279,0,5,0,194
1121,AgenteBasico,89999279,89999274,-5,5,-1,189
1122,AgenteBasico,89999274,89999274,0,5,0,183
1123,AgenteBasico,89999274,89999271,-3,0,-1,179
1124,AgenteBasico,89999271,89999271,0,10,0,173
1125,AgenteBasico,89999271,89999276,5,5,1,166
1126,AgenteBasico,89999276,89999281,5,5,1,160
1127,AgenteBasico,89999281,89999276,-5,5,-1,154
1128,AgenteBasico,89999276,89999276,0,5,0,148
1129,AgenteBasico,89999276,89999271,-5,5,-1,143
1130,AgenteBasico,89999271,89999266,-5,5,-1,136
1131,AgenteBasico,89999266,89999266,0,5,0,131
1132,AgenteBasico,89999266,89999271,5,5,1,127
1133,AgenteBasico,89999271,89999266,-5,5,-1,121
1134,AgenteBasico,89999266,89999261,-5,5,-1,116
1135,AgenteBasico,89999261,89999261,0,5,0,111
1136,AgenteBasico,89999261,89999256,-5,5,-1,106
1137,AgenteBasico,89999256,89999263,7,5,1,101
1138,AgenteBasico,89999263,89999263,0,10,0,96
1139,AgenteBasico,89999263,89999263,0,5,0,90
1140,AgenteBasico,89999263,89999258,-5,5,-1,86
1141,AgenteBasico,89999258,89999253,-5,5,-1,79
1142,AgenteBasico,89999253,89999248,-5,5,-1,70
1143,AgenteBasico,89999248,89999253,5,5,1,65
1144,AgenteBasico,89999253,89999243,-10,10,-1,60
1145,AgenteBasico,89999243,89999248,5,5,1,54
1146,AgenteBasico,89999248,89999255,7,5,1,49
1147,AgenteBasico,89999255,89999250,-5,5,-1,45
1148,AgenteBasico,89999250,89999245,-5,5,-1,40
1149,AgenteBasico,89999245,89999245,0,5,0,202
1150,AgenteBasico,89999245,89999242,-3,0,-1,197
1151,AgenteBasico,89999242,89999249,7,5,1,193
1152,AgenteBasico,89999249,89999256,7,5,1,188
1153,AgenteBasico,89999256,89999261,5,5,1,184
1154,AgenteBasico,89999261,89999266,5,5,1,179
1155,AgenteBasico,89999266,89999261,-5,5,-1,174
1156,AgenteBasico,89999261,89999261,0,5,0,166
1157,AgenteBasico,89999261,89999256,-5,5,-1,161
1158,AgenteBasico,89999256,89999246,-10,10,-1,155
1159,AgenteBasico,89999246,89999246,0,5,0,149
1160,AgenteBasico,89999246,89999246,0,5,0,143
1161,AgenteBasico,89999246,89999246,0,5,0,138
1162,AgenteBasico,89999246,89999246,0,5,0,134
1163,AgenteBasico,89999246,89999241,-5,5,-1,129
1164,AgenteBasico,89999241,89999236,-5,5,-1,124
1165,AgenteBasico,89999236,89999243,7,5,1,119
1166,AgenteBasico,89999243,89999238,-5,5,-1,114
1167,AgenteBasico,89999238,89999235,-3,0,-1,108
1168,AgenteBasico,89999235,89999230,-5,5,-1,103
1169,AgenteBasico,89999230,89999220,-10,10,-1,98
1170,AgenteBasico,89999220,89999235,15,15,1,92
1171,AgenteBasico,89999235,89999242,7,5,1,78
1172,AgenteBasico,89999242,89999247,5,5,1,73
1173,AgenteBasico,89999247,89999252,5,5,1,67
1174,AgenteBasico,89999252,89999257,5,5,1,61
1175,AgenteBasico,89999257,89999262,5,5,1,56
1176,AgenteBasico,89999262,89999257,-5,5,-1,51
1177,AgenteBasico,89999257,89999252,-5,5,-1,203
1178,AgenteBasico,89999252,89999257,5,5,1,198
1179,AgenteBasico,89999257,89999257,0,5,0,193
1180,AgenteBasico,89999257,89999257,0,5,0,187
1181,AgenteBasico,89999257,89999257,0,10,0,182
1182,AgenteBasico,89999257,89999262,5,5,1,177
1183,AgenteBasico,89999262,89999262,0,5,0,171
1184,AgenteBasico,89999262,89999262,0,5,0,165
1185,AgenteBasico,89999262,89999262,0,5,0,160
1186,AgenteBasico,89999262,89999257,-5,5,-1,155
1187,AgenteBasico,89999257,89999262,5,5,1,149
1188,AgenteBasico,89999262,89999257,-5,5,-1,144
1189,AgenteBasico,89999257,89999262,5,5,1,138
1190,AgenteBasico,89999262,89999257,-5,5,-1,133
1191,AgenteBasico,89999257,89999254,-3,0,-1,128
1192,AgenteBasico,89999254,89999259,5,5,1,123
1193,AgenteBasico,89999259,89999254,-5,5,-1,118
1194,AgenteBasico,89999254,89999249,-5,5,-1,110
1195,AgenteBasico,89999249,89999249,0,5,0,105
1196,AgenteBasico,89999249,89999249,0,5,0,100
1197,AgenteBasico,89999249,89999249,0,5,0,92
1198,AgenteBasico,89999249,89999239,-10,15,-1,87
1199,AgenteBasico,89999239,89999244,5,5,1,78
1200,AgenteBasico,89999244,89999239,-5,5,-1,69
1201,AgenteBasico,89999239,89999244,5,5,1,64
1202,AgenteBasico,89999244,89999244,0,5,0,57
1203,AgenteBasico,89999244,89999239,-5,5,-1,51
1204,AgenteBasico,89999239,89999249,10,10,1,46
1205,AgenteBasico,89999249,89999244,-5,5,-1,39
1206,AgenteBasico,89999244,89999239,-5,5,-1,32
1207,AgenteBasico,89999239,89999244,5,5,1,202
1208,AgenteBasico,89999244,89999239,-5,5,-1,195
1209,AgenteBasico,89999239,89999239,0,5,0,189
1210,AgenteBasico,89999239,89999244,5,5,1,182
1211,AgenteBasico,89999244,89999254,10,10,1,176
1212,AgenteBasico,89999254,89999251,-3,0,-1,169
1213,AgenteBasico,89999251,89999246,-5,5,-1,164
1214,AgenteBasico,89999246,89999246,0,5,0,158
1215,AgenteBasico,89999246,89999241,-5,5,-1,152
1216,AgenteBasico,89999241,89999236,-5,5,-1,147
1217,AgenteBasico,89999236,89999236,0,5,0,141
1218,AgenteBasico,89999236,89999231,-5,5,-1,136
1219,AgenteBasico,89999231,89999236,5,5,1,131
1220,AgenteBasico,89999236,89999231,-5,5,-1,126
1221,AgenteBasico,89999231,89999236,5,5,1,121
1222,AgenteBasico,89999236,89999231,-5,5,-1,116
1223,AgenteBasico,89999231,89999226,-5,5,-1,111
1224,AgenteBasico,89999226,89999226,0,5,0,107
1225,AgenteBasico,89999226,89999226,0,5,0,103
1226,AgenteBasico,89999226,89999221,-5,5,-1,98
1227,AgenteBasico,89999221,89999216,-5,5,-1,92
1228,AgenteBasico,89999216,89999216,0,5,0,85
1229,AgenteBasico,89999216,89999211,-5,5,-1,79
1230,AgenteBasico,89999211,89999216,5,5,1,74
1231,AgenteBasico,89999216,89999211,-5,5,-1,67
1232,AgenteBasico,89999211,89999211,0,5,0,62
1233,AgenteBasico,89999211,89999216,5,5,1,58
1234,AgenteBasico,89999216,89999216,0,5,0,53
1235,AgenteBasico,89999216,89999221,5,5,1,47
1236,AgenteBasico,89999221,89999216,-5,5,-1,202
1237,AgenteBasico,89999216,89999211,-5,5,-1,198
1238,AgenteBasico,89999211,89999211,0,10,0,192
1239,AgenteBasico,89999211,89999206,-5,5,-1,186
1240,AgenteBasico,89999206,89999211,5,5,1,182
1241,AgenteBasico,89999211,89999206,-5,5,-1,176
1242,AgenteBasico,89999206,89999216,10,10,1,172
1243,AgenteBasico,89999216,89999213,-3,0,-1,165
1244,AgenteBasico,89999213,89999223,10,10,1,161
1245,AgenteBasico,89999223,89999223,0,5,0,155
1246,AgenteBasico,89999223,89999218,-5,5,-1,151
1247,AgenteBasico,89999218,89999213,-5,5,-1,144
1248,AgenteBasico,89999213,89999213,0,5,0,139
1249,AgenteBasico,89999213,89999213,0,5,0,133
1250,AgenteBasico,89999213,89999208,-5,5,-1,128
1251,AgenteBasico,89999208,89999203,-5,5,-1,123
1252,AgenteBasico,89999203,89999198,-5,5,-1,118
1253,AgenteBasico,89999198,89999203,5,5,1,112
1254,AgenteBasico,89999203,89999198,-5,5,-1,106
1255,AgenteBasico,89999198,89999203,5,5,1,101
1256,AgenteBasico,89999203,89999198,-5,5,-1,96
1257,AgenteBasico,89999198,89999195,-3,0,-1,91
1258,AgenteBasico,89999195,89999190,-5,5,-1,87
1259,AgenteBasico,89999190,89999185,-5,5,-1,82
1260,AgenteBasico,89999185,89999185,0,5,0,77
1261,AgenteBasico,89999185,89999190,5,5,1,72
1262,AgenteBasico,89999190,89999190,0,5,0,65
1263,AgenteBasico,89999190,89999200,10,10,1,61
1264,AgenteBasico,89999200,89999205,5,5,1,55
1265,AgenteBasico,89999205,89999200,-5,5,-1,47
1266,AgenteBasico,89999200,89999195,-5,5,-1,42
1267,AgenteBasico,89999195,89999200,5,5,1,202
1268,AgenteBasico,89999200,89999195,-5,5,-1,197
1269,AgenteBasico,89999195,89999190,-5,5,-1,191
1270,AgenteBasico,89999190,89999180,-10,10,-1,184
1271,AgenteBasico,89999180,89999185,5,5,1,178
1272,AgenteBasico,89999185,89999185,0,5,0,172
1273,AgenteBasico,89999185,89999180,-5,5,-1,167
1274,AgenteBasico,89999180,89999175,-5,5,-1,161
1275,AgenteBasico,89999175,89999175,0,5,0,155
1276,AgenteBasico,89999175,89999170,-5,5,-1,150
1277,AgenteBasico,89999170,89999165,-5,5,-1,144
1278,AgenteBasico,89999165,89999160,-5,5,-1,139
1279,AgenteBasico,89999160,89999155,-5,5,-1,133
1280,AgenteBasico,89999155,89999160,5,5,1,129
1281,AgenteBasico,89999160,89999165,5,5,1,123
1282,AgenteBasico,89999165,89999175,10,10,1,116
1283,AgenteBasico,89999175,89999165,-10,10,-1,110
1284,AgenteBasico,89999165,89999160,-5,5,-1,103
1285,AgenteBasico,89999160,89999165,5,5,1,96
1286,AgenteBasico,89999165,89999162,-3,0,-1,91
1287,AgenteBasico,89999162,89999162,0,5,0,87
1288,AgenteBasico,89999162,89999162,0,5,0,81
1289,AgenteBasico,89999162,89999159,-3,0,-1,76
1290,AgenteBasico,89999159,89999159,0,5,0,71
1291,AgenteBasico,89999159,89999159,0,10,0,66
1292,AgenteBasico,89999159,89999156,-3,0,-1,60
1293,AgenteBasico,89999156,89999146,-10,10,-1,56
1294,AgenteBasico,89999146,89999141,-5,5,-1,51
1295,AgenteBasico,89999141,89999136,-5,10,-1,46
1296,AgenteBasico,89999136,89999136,0,5,0,202
1297,AgenteBasico,89999136,89999136,0,10,0,195
1298,AgenteBasico,89999136,89999121,-15,15,-1,190
1299,AgenteBasico,89999121,89999121,0,10,0,182
1300,AgenteBasico,89999121,89999116,-5,5,-1,176
1301,AgenteBasico,89999116,89999111,-5,5,-1,169
1302,AgenteBasico,89999111,89999121,10,10,1,162
1303,AgenteBasico,89999121,89999126,5,5,1,156
1304,AgenteBasico,89999126,89999126,0,5,0,151
1305,AgenteBasico,89999126,89999131,5,5,1,147
1306,AgenteBasico,89999131,89999131,0,5,0,142
1307,AgenteBasico,89999131,89999126,-5,5,-1,137
1308,AgenteBasico,89999126,89999121,-5,5,-1,132
1309,AgenteBasico,89999121,89999121,0,5,0,127
1310,AgenteBasico,89999121,89999111,-10,10,-1,121
1311,AgenteBasico,89999111,89999106,-5,5,-1,116
1312,AgenteBasico,89999106,89999096,-10,10,-1,111
1313,AgenteBasico,89999096,89999091,-5,5,-1,105
1314,AgenteBasico,89999091,89999101,10,10,1,99
1315,AgenteBasico,89999101,89999106,5,5,1,93
1316,AgenteBasico,89999106,89999111,5,5,1,86
1317,AgenteBasico,89999111,89999111,0,5,0,80
1318,AgenteBasico,89999111,89999106,-5,5,-1,75
1319,AgenteBasico,89999106,89999101,-5,5,-1,69
1320,AgenteBasico,89999101,89999111,10,10,1,63
1321,AgenteBasico,89999111,89999106,-5,5,-1,56
1322,AgenteBasico,89999106,89999101,-5,5,-1,49
1323,AgenteBasico,89999101,89999096,-5,5,-1,203
1324,AgenteBasico,89999096,89999091,-5,5,-1,198
1325,AgenteBasico,89999091,89999086,-5,5,-1,192
1326,AgenteBasico,89999086,89999086,0,5,0,187
1327,AgenteBasico,89999086,89999091,5,5,1,182
1328,AgenteBasico,89999091,89999091,0,5,0,177
1329,AgenteBasico,89999091,89999096,5,5,1,172
1330,AgenteBasico,89999096,89999091,-5,5,-1,165
1331,AgenteBasico,89999091,89999086,-5,5,-1,160
1332,AgenteBasico,89999086,89999081,-5,5,-1,154
1333,AgenteBasico,89999081,89999076,-5,5,-1,149
1334,AgenteBasico,89999076,89999073,-3,0,-1,142
1335,AgenteBasico,89999073,89999073,0,5,0,137
1336,AgenteBasico,89999073,89999063,-10,10,-1,133
1337,AgenteBasico,89999063,89999058,-5,5,-1,127
1338,AgenteBasico,89999058,89999058,0,10,0,121
1339,AgenteBasico,89999058,89999063,5,5,1,115
1340,AgenteBasico,89999063,89999058,-5,5,-1,109
1341,AgenteBasico,89999058,89999063,5,5,1,103
1342,AgenteBasico,89999063,89999068,5,5,1,96
1343,AgenteBasico,89999068,89999053,-15,15,-1,89
1344,AgenteBasico,89999053,89999048,-5,5,-1,80
1345,AgenteBasico,89999048,89999043,-5,5,-1,74
1346,AgenteBasico,89999043,89999053,10,10,1,70
1347,AgenteBasico,89999053,89999048,-5,5,-1,64
1348,AgenteBasico,89999048,89999053,5,5,1,57
1349,AgenteBasico,89999053,89999058,5,5,1,51
1350,AgenteBasico,89999058,89999058,0,5,0,202
1351,AgenteBasico,89999058,89999053,-5,5,-1,197
1352,AgenteBasico,89999053,89999063,10,10,1,190
1353,AgenteBasico,89999063,89999070,7,5,1,183
1354,AgenteBasico,89999070,89999070,0,5,0,178
1355,AgenteBasico,89999070,89999070,0,5,0,174
1356,AgenteBasico,89999070,89999075,5,5,1,170
1357,AgenteBasico,89999075,89999072,-3,0,-1,165
1358,AgenteBasico,89999072,89999067,-5,5,-1,160
1359,AgenteBasico,89999067,89999072,5,5,1,153
1360,AgenteBasico,89999072,89999077,5,5,1,148
1361,AgenteBasico,89999077,89999077,0,10,0,143
1362,AgenteBasico,89999077,89999067,-10,10,-1,137
1363,AgenteBasico,89999067,89999062,-5,5,-1,131
1364,AgenteBasico,89999062,89999067,5,5,1,125
1365,AgenteBasico,89999067,89999072,5,5,1,120
1366,AgenteBasico,89999072,89999079,7,5,1,115
1367,AgenteBasico,89999079,89999086,7,5,1,110
1368,AgenteBasico,89999086,89999081,-5,5,-1,106
1369,AgenteBasico,89999081,89999086,5,5,1,102
1370,AgenteBasico,89999086,89999081,-5,5,-1,97
1371,AgenteBasico,89999081,89999081,0,5,0,92
1372,AgenteBasico,89999081,89999076,-5,5,-1,87
1373,AgenteBasico,89999076,89999071,-5,5,-1,82
1374,AgenteBasico,89999071,89999071,0,5,0,77
1375,AgenteBasico,89999071,89999066,-5,5,-1,71
1376,AgenteBasico,89999066,89999071,5,5,1,66
1377,AgenteBasico,89999071,89999071,0,5,0,59
1378,AgenteBasico,89999071,89999076,5,5,1,52
1379,AgenteBasico,89999076,89999071,-5,5,-1,46
1380,AgenteBasico,89999071,89999078,7,5,1,40
1381,AgenteBasico,89999078,89999078,0,5,0,202
1382,AgenteBasico,89999078,89999068,-10,10,-1,195
1383,AgenteBasico,89999068,89999063,-5,5,-1,189
1384,AgenteBasico,89999063,89999068,5,5,1,182
1385,AgenteBasico,89999068,89999058,-10,10,-1,177
1386,AgenteBasico,89999058,89999063,5,5,1,172
1387,AgenteBasico,89999063,89999063,0,10,0,167
1388,AgenteBasico,89999063,89999058,-5,5,-1,161
1389,AgenteBasico,89999058,89999063,5,5,1,157
1390,AgenteBasico,89999063,89999058,-5,5,-1,152
1391,AgenteBasico,89999058,89999053,-5,5,-1,147
1392,AgenteBasico,89999053,89999048,-5,5,-1,142
1393,AgenteBasico,89999048,89999058,10,10,1,136
1394,AgenteBasico,89999058,89999063,5,5,1,130
1395,AgenteBasico,89999063,89999063,0,5,0,125
1396,AgenteBasico,89999063,89999058,-5,5,-1,120
1397,AgenteBasico,89999058,89999058,0,5,0,115
1398,AgenteBasico,89999058,89999068,10,10,1,109
1399,AgenteBasico,89999068,89999063,-5,5,-1,103
1400,AgenteBasico,89999063,89999063,0,5,0,96
1401,AgenteBasico,89999063,89999068,5,5,1,91
1402,AgenteBasico,89999068,89999063,-5,5,-1,85
1403,AgenteBasico,89999063,89999058,-5,5,-1,80
1404,AgenteBasico,89999058,89999063,5,5,1,76
1405,AgenteBasico,89999063,89999053,-10,10,-1,71
1406,AgenteBasico,89999053,89999058,5,5,1,65
1407,AgenteBasico,89999058,89999055,-3,0,-1,58
1408,AgenteBasico,89999055,89999055,0,5,0,54
1409,AgenteBasico,89999055,89999060,5,5,1,50
1410,AgenteBasico,89999060,89999060,0,5,0,43
1411,AgenteBasico,89999060,89999067,7,5,1,202
1412,AgenteBasico,89999067,89999062,-5,5,-1,197
1413,AgenteBasico,89999062,89999069,7,5,1,191
1414,AgenteBasico,89999069,89999069,0,10,0,186
1415,AgenteBasico,89999069,89999079,10,10,1,181
1416,AgenteBasico,89999079,89999074,-5,5,-1,173
1417,AgenteBasico,89999074,89999069,-5,5,-1,168
1418,AgenteBasico,89999069,89999064,-5,5,-1,162
1419,AgenteBasico,89999064,89999064,0,5,0,156
1420,AgenteBasico,89999064,89999064,0,10,0,151
1421,AgenteBasico,89999064,89999074,10,10,1,145
1422,AgenteBasico,89999074,89999074,0,10,0,139
1423,AgenteBasico,89999074,89999069,-5,5,-1,132
1424,AgenteBasico,89999069,89999064,-5,5,-1,125
1425,AgenteBasico,89999064,89999059,-5,5,-1,118
1426,AgenteBasico,89999059,89999059,0,5,0,114
1427,AgenteBasico,89999059,89999054,-5,5,-1,110
1428,AgenteBasico,89999054,89999059,5,5,1,103
1429,AgenteBasico,89999059,89999054,-5,5,-1,95
1430,AgenteBasico,89999054,89999049,-5,5,-1,90
1431,AgenteBasico,89999049,89999054,5,5,1,85
1432,AgenteBasico,89999054,89999049,-5,5,-1,80
1433,AgenteBasico,89999049,89999044,-5,5,-1,74
1434,AgenteBasico,89999044,89999044,0,5,0,68
1435,AgenteBasico,89999044,89999039,-5,5,-1,63
1436,AgenteBasico,89999039,89999034,-5,5,-1,58
1437,AgenteBasico,89999034,89999039,5,5,1,54
1438,AgenteBasico,89999039,89999046,7,5,1,49
1439,AgenteBasico,89999046,89999051,5,5,1,44
1440,AgenteBasico,89999051,89999051,0,5,0,39
1441,AgenteBasico,89999051,89999046,-5,5,-1,204
1442,AgenteBasico,89999046,89999051,5,5,1,198
1443,AgenteBasico,89999051,89999046,-5,5,-1,192
1444,AgenteBasico,89999046,89999041,-5,5,-1,187
1445,AgenteBasico,89999041,89999036,-5,5,-1,183
1446,AgenteBasico,89999036,89999026,-10,10,-1,177
1447,AgenteBasico,89999026,89999023,-3,0,-1,171
1448,AgenteBasico,89999023,89999018,-5,5,-1,166
1449,AgenteBasico,89999018,89999018,0,5,0,160
1450,AgenteBasico,89999018,89999013,-5,10,-1,156
1451,AgenteBasico,89999013,89999013,0,5,0,148
1452,AgenteBasico,89999013,89999008,-5,5,-1,142
1453,AgenteBasico,89999008,89999005,-3,0,-1,136
1454,AgenteBasico,89999005,89999005,0,5,0,132
1455,AgenteBasico,89999005,89999010,5,5,1,126
1456,AgenteBasico,89999010,89999017,7,5,1,121
1457,AgenteBasico,89999017,89999012,-5,5,-1,117
1458,AgenteBasico,89999012,89999007,-5,5,-1,110
1459,AgenteBasico,89999007,89999007,0,5,0,103
1460,AgenteBasico,89999007,89999012,5,5,1,97
1461,AgenteBasico,89999012,89999012,0,5,0,91
1462,AgenteBasico,89999012,89999012,0,5,0,87
1463,AgenteBasico,89999012,89999017,5,5,1,81
1464,AgenteBasico,89999017,89999027,10,10,1,75
1465,AgenteBasico,89999027,89999024,-3,0,-1,69
1466,AgenteBasico,89999024,89999019,-5,5,-1,64
1467,AgenteBasico,89999019,89999024,5,5,1,57
1468,AgenteBasico,89999024,89999024,0,5,0,51
1469,AgenteBasico,89999024,89999024,0,5,0,43
1470,AgenteBasico,89999024,89999029,5,5,1,203
1471,AgenteBasico,89999029,89999024,-5,5,-1,195
1472,AgenteBasico,89999024,89999019,-5,5,-1,189
1473,AgenteBasico,89999019,89999014,-5,5,-1,184
1474,AgenteBasico,89999014,89999021,7,5,1,178
1475,AgenteBasico,89999021,89999016,-5,5,-1,173
1476,AgenteBasico,89999016,89999011,-5,5,-1,167
1477,AgenteBasico,89999011,89999006,-5,5,-1,162
1478,AgenteBasico,89999006,89999011,5,5,1,157
1479,AgenteBasico,89999011,89999006,-5,5,-1,151
1480,AgenteBasico,89999006,89999006,0,5,0,146
1481,AgenteBasico,89999006,89999011,5,5,1,141
1482,AgenteBasico,89999011,89999016,5,5,1,135
1483,AgenteBasico,89999016,89999011,-5,5,-1,128
1484,AgenteBasico,89999011,89999016,5,5,1,122
1485,AgenteBasico,89999016,89999016,0,5,0,117
1486,AgenteBasico,89999016,89999016,0,5,0,111
1487,AgenteBasico,89999016,89999006,-10,10,-1,106
1488,AgenteBasico,89999006,89999001,-5,5,-1,100
1489,AgenteBasico,89999001,89998996,-5,5,-1,95
1490,AgenteBasico,89998996,89998991,-5,5,-1,91
1491,AgenteBasico,89998991,89998986,-5,5,-1,87
1492,AgenteBasico,89998986,89998983,-3,0,-1,82
1493,AgenteBasico,89998983,89998978,-5,5,-1,78
1494,AgenteBasico,89998978,89998985,7,5,1,74
1495,AgenteBasico,89998985,89998980,-5,15,-1,69
1496,AgenteBasico,89998980,89998975,-5,5,-1,61
1497,AgenteBasico,89998975,89998985,10,10,1,56
1498,AgenteBasico,89998985,89998985,0,5,0,50
1499,AgenteBasico,89998985,89998980,-5,5,-1,44
1500,AgenteBasico,89998980,89998975,-5,5,-1,40
1501,AgenteBasico,89998975,89998970,-5,5,-1,35
1502,AgenteBasico,89998970,89998965,-5,5,-1,203
1503,AgenteBasico,89998965,89998970,5,5,1,196
1504,AgenteBasico,89998970,89998965,-5,5,-1,191
1505,AgenteBasico,89998965,89998955,-10,10,-1,185
1506,AgenteBasico,89998955,89998950,-5,5,-1,180
1507,AgenteBasico,89998950,89998950,0,5,0,175
1508,AgenteBasico,89998950,89998950,0,5,0,171
1509,AgenteBasico,89998950,89998947,-3,0,-1,167
1510,AgenteBasico,89998947,89998947,0,5,0,162
1511,AgenteBasico,89998947,89998947,0,5,0,158
1512,AgenteBasico,89998947,89998947,0,5,0,153
1513,AgenteBasico,89998947,89998957,10,10,1,147
1514,AgenteBasico,89998957,89998952,-5,5,-1,141
1515,AgenteBasico,89998952,89998957,5,5,1,133
1516,AgenteBasico,89998957,89998952,-5,5,-1,126
1517,AgenteBasico,89998952,89998949,-3,0,-1,120
1518,AgenteBasico,89998949,89998949,0,5,0,116
1519,AgenteBasico,89998949,89998944,-5,5,-1,110
1520,AgenteBasico,89998944,89998939,-5,5,-1,103
1521,AgenteBasico,89998939,89998934,-5,5,-1,99
1522,AgenteBasico,89998934,89998929,-5,5,-1,94
1523,AgenteBasico,89998929,89998934,5,5,1,89
1524,AgenteBasico,89998934,89998941,7,5,1,82
1525,AgenteBasico,89998941,89998936,-5,5,-1,76
1526,AgenteBasico,89998936,89998936,0,5,0,69
1527,AgenteBasico,89998936,89998936,0,10,0,63
1528,AgenteBasico,89998936,89998936,0,5,0,57
1529,AgenteBasico,89998936,89998941,5,5,1,52
1530,AgenteBasico,89998941,89998946,5,5,1,46
1531,AgenteBasico,89998946,89998951,5,5,1,40
1532,AgenteBasico,89998951,89998951,0,5,0,35
1533,AgenteBasico,89998951,89998961,10,10,1,203
1534,AgenteBasico,89998961,89998956,-5,5,-1,197
1535,AgenteBasico,89998956,89998951,-5,5,-1,192
1536,AgenteBasico,89998951,89998948,-3,0,-1,185
1537,AgenteBasico,89998948,89998938,-10,10,-1,181
1538,AgenteBasico,89998938,89998948,10,10,1,175
1539,AgenteBasico,89998948,89998955,7,5,1,169
1540,AgenteBasico,89998955,89998950,-5,5,-1,165
1541,AgenteBasico,89998950,89998950,0,5,0,159
1542,AgenteBasico,89998950,89998945,-5,5,-1,154
1543,AgenteBasico,89998945,89998952,7,5,1,147
1544,AgenteBasico,89998952,89998947,-5,5,-1,143
1545,AgenteBasico,89998947,89998942,-5,5,-1,137
1546,AgenteBasico,89998942,89998947,5,5,1,130
1547,AgenteBasico,89998947,89998954,7,5,1,124
1548,AgenteBasico,89998954,89998954,0,5,0,118
1549,AgenteBasico,89998954,89998954,0,5,0,114
1550,AgenteBasico,89998954,89998959,5,5,1,110
1551,AgenteBasico,89998959,89998954,-5,5,-1,104
1552,AgenteBasico,89998954,89998949,-5,10,-1,99
1553,AgenteBasico,89998949,89998949,0,5,0,92
1554,AgenteBasico,89998949,89998954,5,5,1,87
1555,AgenteBasico,89998954,89998959,5,5,1,79
1556,AgenteBasico,89998959,89998954,-5,5,-1,74
1557,AgenteBasico,89998954,89998959,5,5,1,69
1558,AgenteBasico,89998959,89998959,0,5,0,64
1559,AgenteBasico,89998959,89998964,5,5,1,60
1560,AgenteBasico,89998964,89998959,-5,5,-1,53
1561,AgenteBasico,89998959,89998964,5,5,1,48
1562,AgenteBasico,89998964,89998964,0,10,0,43
1563,AgenteBasico,89998964,89998971,7,5,1,202
1564,AgenteBasico,89998971,89998966,-5,5,-1,197
1565,AgenteBasico,89998966,89998961,-5,5,-1,190
1566,AgenteBasico,89998961,89998961,0,5,0,184
1567,AgenteBasico,89998961,89998966,5,5,1,179
1568,AgenteBasico,89998966,89998971,5,5,1,172
1569,AgenteBasico,89998971,89998968,-3,0,-1,165
1570,AgenteBasico,89998968,89998973,5,5,1,161
1571,AgenteBasico,89998973,89998968,-5,5,-1,156
1572,AgenteBasico,89998968,89998963,-5,5,-1,151
1573,AgenteBasico,89998963,89998958,-5,5,-1,145
1574,AgenteBasico,89998958,89998968,10,10,1,139
1575,AgenteBasico,89998968,89998968,0,5,0,132
1576,AgenteBasico,89998968,89998973,5,5,1,124
1577,AgenteBasico,89998973,89998968,-5,5,-1,117
1578,AgenteBasico,89998968,89998968,0,5,0,112
1579,AgenteBasico,89998968,89998968,0,10,0,107
1580,AgenteBasico,89998968,89998958,-10,10,-1,102
1581,AgenteBasico,89998958,89998963,5,5,1,97
1582,AgenteBasico,89998963,89998958,-5,5,-1,90
1583,AgenteBasico,89998958,89998955,-3,0,-1,85
1584,AgenteBasico,89998955,89998962,7,5,1,79
1585,AgenteBasico,89998962,89998957,-5,5,-1,73
1586,AgenteBasico,89998957,89998964,7,5,1,69
1587,AgenteBasico,89998964,89998964,0,5,0,64
1588,AgenteBasico,89998964,89998964,0,5,0,60
1589,AgenteBasico,89998964,89998954,-10,10,-1,55
1590,AgenteBasico,89998954,89998959,5,5,1,50
1591,AgenteBasico,89998959,89998956,-3,0,-1,44
1592,AgenteBasico,89998956,89998961,5,5,1,40
1593,AgenteBasico,89998961,89998956,-5,5,-1,34
1594,AgenteBasico,89998956,89998956,0,5,0,202
1595,AgenteBasico,89998956,89998956,0,5,0,198
1596,AgenteBasico,89998956,89998951,-5,5,-1,192
1597,AgenteBasico,89998951,89998941,-10,10,-1,186
1598,AgenteBasico,89998941,89998941,0,5,0,180
1599,AgenteBasico,89998941,89998941,0,10,0,175
1600,AgenteBasico,89998941,89998941,0,5,0,169
1601,AgenteBasico,89998941,89998941,0,5,0,164
1602,AgenteBasico,89998941,89998941,0,10,0,160
1603,AgenteBasico,89998941,89998941,0,5,0,155
1604,AgenteBasico,89998941,89998941,0,5,0,151
1605,AgenteBasico,89998941,89998946,5,5,1,147
1606,AgenteBasico,89998946,89998951,5,5,1,141
1607,AgenteBasico,89998951,89998951,0,5,0,136
1608,AgenteBasico,89998951,89998958,7,5,1,132
1609,AgenteBasico,89998958,89998963,5,5,1,127
1610,AgenteBasico,89998963,89998963,0,5,0,122
1611,AgenteBasico,89998963,89998968,5,5,1,115
1612,AgenteBasico,89998968,89998968,0,5,0,110
1613,AgenteBasico,89998968,89998968,0,5,0,104
1614,AgenteBasico,89998968,89998965,-3,0,-1,100
1615,AgenteBasico,89998965,89998960,-5,5,-1,96
1616,AgenteBasico,89998960,89998965,5,5,1,90
1617,AgenteBasico,89998965,89998965,0,5,0,84
1618,AgenteBasico,89998965,89998960,-5,5,-1,78
1619,AgenteBasico,89998960,89998960,0,5,0,72
1620,AgenteBasico,89998960,89998967,7,5,1,67
1621,AgenteBasico,89998967,89998962,-5,5,-1,62
1622,AgenteBasico,89998962,89998962,0,5,0,58
1623,AgenteBasico,89998962,89998962,0,5,0,54
1624,AgenteBasico,89998962,89998967,5,5,1,49
1625,AgenteBasico,89998967,89998957,-10,10,-1,44
1626,AgenteBasico,89998957,89998957,0,5,0,37
1627,AgenteBasico,89998957,89998957,0,5,0,203
1628,AgenteBasico,89998957,89998952,-5,5,-1,199
1629,AgenteBasico,89998952,89998947,-5,5,-1,192
1630,AgenteBasico,89998947,89998942,-5,5,-1,187
1631,AgenteBasico,89998942,89998942,0,5,0,181
1632,AgenteBasico,89998942,89998947,5,5,1,177
1633,AgenteBasico,89998947,89998942,-5,5,-1,171
1634,AgenteBasico,89998942,89998947,5,5,1,166
1635,AgenteBasico,89998947,89998947,0,5,0,161
1636,AgenteBasico,89998947,89998947,0,5,0,156
1637,AgenteBasico,89998947,89998942,-5,5,-1,151
1638,AgenteBasico,89998942,89998937,-5,5,-1,144
1639,AgenteBasico,89998937,89998937,0,5,0,137
1640,AgenteBasico,89998937,89998942,5,5,1,132
1641,AgenteBasico,89998942,89998937,-5,5,-1,126
1642,AgenteBasico,89998937,89998932,-5,5,-1,119
1643,AgenteBasico,89998932,89998927,-5,5,-1,114
1644,AgenteBasico,89998927,89998927,0,5,0,108
1645,AgenteBasico,89998927,89998922,-5,5,-1,104
1646,AgenteBasico,89998922,89998927,5,5,1,98
1647,AgenteBasico,89998927,89998932,5,5,1,91
1648,AgenteBasico,89998932,89998927,-5,5,-1,83
1649,AgenteBasico,89998927,89998927,0,5,0,77
1650,AgenteBasico,89998927,89998922,-5,5,-1,72
1651,AgenteBasico,89998922,89998917,-5,5,-1,66
1652,AgenteBasico,89998917,89998912,-5,5,-1,58
1653,AgenteBasico,89998912,89998907,-5,5,-1,53
1654,AgenteBasico,89998907,89998907,0,5,0,48
1655,AgenteBasico,89998907,89998902,-5,5,-1,203
1656,AgenteBasico,89998902,89998907,5,5,1,198
1657,AgenteBasico,89998907,89998902,-5,5,-1,192
1658,AgenteBasico,89998902,89998902,0,5,0,187
1659,AgenteBasico,89998902,89998902,0,5,0,180
1660,AgenteBasico,89998902,89998897,-5,5,-1,175
1661,AgenteBasico,89998897,89998894,-3,0,-1,170
1662,AgenteBasico,89998894,89998889,-5,5,-1,166
1663,AgenteBasico,89998889,89998884,-5,5,-1,160
1664,AgenteBasico,89998884,89998884,0,5,0,152
1665,AgenteBasico,89998884,89998879,-5,5,-1,147
1666,AgenteBasico,89998879,89998879,0,10,0,141
1667,AgenteBasico,89998879,89998874,-5,5,-1,136
1668,AgenteBasico,89998874,89998869,-5,5,-1,130
1669,AgenteBasico,89998869,89998869,0,5,0,123
1670,AgenteBasico,89998869,89998864,-5,5,-1,118
1671,AgenteBasico,89998864,89998856,-8,5,-1,114
1672,AgenteBasico,89998856,89998861,5,5,1,108
1673,AgenteBasico,89998861,89998861,0,10,0,103
1674,AgenteBasico,89998861,89998856,-5,5,-1,97
1675,AgenteBasico,89998856,89998851,-5,5,-1,91
1676,AgenteBasico,89998851,89998846,-5,5,-1,86
1677,AgenteBasico,89998846,89998841,-5,5,-1,81
1678,AgenteBasico,89998841,89998841,0,5,0,76
1679,AgenteBasico,89998841,89998836,-5,5,-1,70
1680,AgenteBasico,89998836,89998836,0,5,0,65
1681,AgenteBasico,89998836,89998831,-5,5,-1,59
1682,AgenteBasico,89998831,89998836,5,5,1,53
1683,AgenteBasico,89998836,89998836,0,5,0,48
1684,AgenteBasico,89998836,89998831,-5,5,-1,43
1685,AgenteBasico,89998831,89998831,0,5,0,39
1686,AgenteBasico,89998831,89998836,5,5,1,202
1687,AgenteBasico,89998836,89998836,0,5,0,195
1688,AgenteBasico,89998836,89998841,5,5,1,190
1689,AgenteBasico,89998841,89998846,5,5,1,184
1690,AgenteBasico,89998846,89998846,0,5,0,178
1691,AgenteBasico,89998846,89998841,-5,5,-1,172
1692,AgenteBasico,89998841,89998836,-5,5,-1,167
1693,AgenteBasico,89998836,89998831,-5,5,-1,162
1694,AgenteBasico,89998831,89998826,-5,5,-1,154
1695,AgenteBasico,89998826,89998826,0,10,0,149
1696,AgenteBasico,89998826,89998821,-5,5,-1,143
1697,AgenteBasico,89998821,89998816,-5,5,-1,139
1698,AgenteBasico,89998816,89998821,5,5,1,132
1699,AgenteBasico,89998821,89998816,-5,5,-1,126
1700,AgenteBasico,89998816,89998816,0,5,0,120
1701,AgenteBasico,89998816,89998811,-5,5,-1,116
1702,AgenteBasico,89998811,89998806,-5,5,-1,110
1703,AgenteBasico,89998806,89998801,-5,5,-1,105
1704,AgenteBasico,89998801,89998796,-5,5,-1,97
1705,AgenteBasico,89998796,89998791,-5,5,-1,92
1706,AgenteBasico,89998791,89998796,5,5,1,87
1707,AgenteBasico,89998796,89998791,-5,5,-1,82
1708,AgenteBasico,89998791,89998791,0,5,0,75
1709,AgenteBasico,89998791,89998786,-5,5,-1,69
1710,AgenteBasico,89998786,89998791,5,5,1,62
1711,AgenteBasico,89998791,89998791,0,5,0,56
1712,AgenteBasico,89998791,89998796,5,5,1,51
1713,AgenteBasico,89998796,89998801,5,5,1,45
1714,AgenteBasico,89998801,89998801,0,5,0,203
1715,AgenteBasico,89998801,89998801,0,5,0,198
1716,AgenteBasico,89998801,89998796,-5,5,-1,193
1717,AgenteBasico,89998796,89998791,-5,5,-1,187
1718,AgenteBasico,89998791,89998786,-5,5,-1,180
1719,AgenteBasico,89998786,89998781,-5,5,-1,172
1720,AgenteBasico,89998781,89998786,5,5,1,165
1721,AgenteBasico,89998786,89998791,5,5,1,159
1722,AgenteBasico,89998791,89998786,-5,5,-1,153
1723,AgenteBasico,89998786,89998791,5,5,1,148
1724,AgenteBasico,89998791,89998786,-5,5,-1,143
1725,AgenteBasico,89998786,89998786,0,5,0,136
1726,AgenteBasico,89998786,89998781,-5,5,-1,132
1727,AgenteBasico,89998781,89998776,-5,5,-1,126
1728,AgenteBasico,89998776,89998771,-5,5,-1,121
1729,AgenteBasico,89998771,89998776,5,5,1,116
1730,AgenteBasico,89998776,89998776,0,10,0,110
1731,AgenteBasico,89998776,89998776,0,5,0,105
1732,AgenteBasico,89998776,89998776,0,5,0,100
1733,AgenteBasico,89998776,89998766,-10,10,-1,95
1734,AgenteBasico,89998766,89998761,-5,5,-1,90
1735,AgenteBasico,89998761,89998761,0,10,0,84
1736,AgenteBasico,89998761,89998761,0,5,0,76
1737,AgenteBasico,89998761,89998761,0,5,0,70
1738,AgenteBasico,89998761,89998756,-5,5,-1,65
1739,AgenteBasico,89998756,89998751,-5,5,-1,60
1740,AgenteBasico,89998751,89998756,5,5,1,54
1741,AgenteBasico,89998756,89998751,-5,5,-1,49
1742,AgenteBasico,89998751,89998746,-5,5,-1,43
1743,AgenteBasico,89998746,89998751,5,5,1,38
1744,AgenteBasico,89998751,89998756,5,5,1,32
1745,AgenteBasico,89998756,89998753,-3,0,-1,203
1746,AgenteBasico,89998753,89998748,-5,5,-1,198
1747,AgenteBasico,89998748,89998748,0,10,0,192
1748,AgenteBasico,89998748,89998738,-10,10,-1,186
1749,AgenteBasico,89998738,89998745,7,5,1,180
1750,AgenteBasico,89998745,89998740,-5,5,-1,175
1751,AgenteBasico,89998740,89998740,0,5,0,170
1752,AgenteBasico,89998740,89998735,-5,5,-1,164
1753,AgenteBasico,89998735,89998735,0,5,0,159
1754,AgenteBasico,89998735,89998735,0,5,0,154
1755,AgenteBasico,89998735,89998735,0,5,0,148
1756,AgenteBasico,89998735,89998730,-5,5,-1,142
1757,AgenteBasico,89998730,89998727,-3,0,-1,138
1758,AgenteBasico,89998727,89998722,-5,5,-1,133
1759,AgenteBasico,89998722,89998727,5,5,1,127
1760,AgenteBasico,89998727,89998722,-5,5,-1,121
1761,AgenteBasico,89998722,89998717,-5,5,-1,115
1762,AgenteBasico,89998717,89998717,0,5,0,111
1763,AgenteBasico,89998717,89998722,5,5,1,101
1764,AgenteBasico,89998722,89998732,10,10,1,96
1765,AgenteBasico,89998732,89998737,5,5,1,89
1766,AgenteBasico,89998737,89998737,0,5,0,84
1767,AgenteBasico,89998737,89998734,-3,0,-1,80
1768,AgenteBasico,89998734,89998734,0,5,0,75
1769,AgenteBasico,89998734,89998729,-5,5,-1,70
1770,AgenteBasico,89998729,89998729,0,5,0,62
1771,AgenteBasico,89998729,89998724,-5,5,-1,56
1772,AgenteBasico,89998724,89998719,-5,5,-1,50
1773,AgenteBasico,89998719,89998719,0,5,0,44
1774,AgenteBasico,89998719,89998714,-5,5,-1,39
1775,AgenteBasico,89998714,89998709,-5,5,-1,203
1776,AgenteBasico,89998709,89998714,5,5,1,198
1777,AgenteBasico,89998714,89998709,-5,5,-1,191
1778,AgenteBasico,89998709,89998719,10,10,1,185
1779,AgenteBasico,89998719,89998714,-5,5,-1,178
1780,AgenteBasico,89998714,89998714,0,5,0,169
1781,AgenteBasico,89998714,89998709,-5,5,-1,163
1782,AgenteBasico,89998709,89998714,5,5,1,157
1783,AgenteBasico,89998714,89998719,5,5,1,152
1784,AgenteBasico,89998719,89998709,-10,10,-1,146
1785,AgenteBasico,89998709,89998704,-5,5,-1,140
1786,AgenteBasico,89998704,89998701,-3,0,-1,134
1787,AgenteBasico,89998701,89998701,0,5,0,130
1788,AgenteBasico,89998701,89998706,5,5,1,125
1789,AgenteBasico,89998706,89998701,-5,5,-1,120
1790,AgenteBasico,89998701,89998696,-5,5,-1,115
1791,AgenteBasico,89998696,89998696,0,5,0,110
1792,AgenteBasico,89998696,89998686,-10,10,-1,105
1793,AgenteBasico,89998686,89998681,-5,5,-1,100
1794,AgenteBasico,89998681,89998676,-5,5,-1,96
1795,AgenteBasico,89998676,89998671,-5,5,-1,88
1796,AgenteBasico,89998671,89998676,5,5,1,83
1797,AgenteBasico,89998676,89998676,0,5,0,78
1798,AgenteBasico,89998676,89998686,10,10,1,72
1799,AgenteBasico,89998686,89998681,-5,5,-1,63
1800,AgenteBasico,89998681,89998681,0,10,0,57
1801,AgenteBasico,89998681,89998676,-5,5,-1,51
1802,AgenteBasico,89998676,89998676,0,5,0,203
1803,AgenteBasico,89998676,89998671,-5,5,-1,198
1804,AgenteBasico,89998671,89998681,10,10,1,190
1805,AgenteBasico,89998681,89998676,-5,5,-1,182
1806,AgenteBasico,89998676,89998683,7,5,1,177
1807,AgenteBasico,89998683,89998678,-5,5,-1,173
1808,AgenteBasico,89998678,89998673,-5,5,-1,168
1809,AgenteBasico,89998673,89998673,0,5,0,162
1810,AgenteBasico,89998673,89998670,-3,0,-1,157
1811,AgenteBasico,89998670,89998665,-5,10,-1,152
1812,AgenteBasico,89998665,89998670,5,5,1,145
1813,AgenteBasico,89998670,89998670,0,10,0,139
1814,AgenteBasico,89998670,89998665,-5,5,-1,133
1815,AgenteBasico,89998665,89998670,5,5,1,127
1816,AgenteBasico,89998670,89998665,-5,5,-1,122
1817,AgenteBasico,89998665,89998660,-5,5,-1,116
1818,AgenteBasico,89998660,89998660,0,5,0,111
1819,AgenteBasico,89998660,89998655,-5,5,-1,106
1820,AgenteBasico,89998655,89998650,-5,5,-1,100
1821,AgenteBasico,89998650,89998650,0,10,0,92
1822,AgenteBasico,89998650,89998647,-3,0,-1,86
1823,AgenteBasico,89998647,89998654,7,5,1,81
1824,AgenteBasico,89998654,89998654,0,5,0,76
1825,AgenteBasico,89998654,89998639,-15,15,-1,70
1826,AgenteBasico,89998639,89998639,0,5,0,61
1827,AgenteBasico,89998639,89998639,0,5,0,55
1828,AgenteBasico,89998639,89998639,0,5,0,50
1829,AgenteBasico,89998639,89998639,0,5,0,43
1830,AgenteBasico,89998639,89998634,-5,5,-1,204
1831,AgenteBasico,89998634,89998629,-5,5,-1,198
1832,AgenteBasico,89998629,89998636,7,5,1,193
1833,AgenteBasico,89998636,89998636,0,5,0,188
1834,AgenteBasico,89998636,89998636,0,5,0,183
1835,AgenteBasico,89998636,89998631,-5,5,-1,179
1836,AgenteBasico,89998631,89998621,-10,10,-1,174
1837,AgenteBasico,89998621,89998616,-5,5,-1,168
1838,AgenteBasico,89998616,89998616,0,10,0,161
1839,AgenteBasico,89998616,89998611,-5,5,-1,155
1840,AgenteBasico,89998611,89998606,-5,5,-1,149
1841,AgenteBasico,89998606,89998601,-5,5,-1,143
1842,AgenteBasico,89998601,89998596,-5,5,-1,137
1843,AgenteBasico,89998596,89998601,5,5,1,131
1844,AgenteBasico,89998601,89998611,10,10,1,123
1845,AgenteBasico,89998611,89998606,-5,5,-1,116
1846,AgenteBasico,89998606,89998606,0,5,0,111
1847,AgenteBasico,89998606,89998606,0,5,0,106
1848,AgenteBasico,89998606,89998611,5,5,1,102
1849,AgenteBasico,89998611,89998606,-5,5,-1,96
1850,AgenteBasico,89998606,89998601,-5,5,-1,89
1851,AgenteBasico,89998601,89998596,-5,5,-1,84
1852,AgenteBasico,89998596,89998591,-5,5,-1,79
1853,AgenteBasico,89998591,89998581,-10,10,-1,74
1854,AgenteBasico,89998581,89998576,-5,5,-1,68
1855,AgenteBasico,89998576,89998571,-5,5,-1,62
1856,AgenteBasico,89998571,89998578,7,5,1,57
1857,AgenteBasico,89998578,89998578,0,5,0,51
1858,AgenteBasico,89998578,89998573,-5,5,-1,45
1859,AgenteBasico,89998573,89998573,0,5,0,40
1860,AgenteBasico,89998573,89998568,-5,5,-1,203
1861,AgenteBasico,89998568,89998568,0,10,0,199
1862,AgenteBasico,89998568,89998563,-5,5,-1,194
1863,AgenteBasico,89998563,89998558,-5,5,-1,189
1864,AgenteBasico,89998558,89998563,5,5,1,183
1865,AgenteBasico,89998563,89998573,10,10,1,178
1866,AgenteBasico,89998573,89998568,-5,5,-1,168
1867,AgenteBasico,89998568,89998565,-3,0,-1,163
1868,AgenteBasico,89998565,89998560,-5,5,-1,159
1869,AgenteBasico,89998560,89998555,-5,5,-1,154
1870,AgenteBasico,89998555,89998560,5,5,1,148
1871,AgenteBasico,89998560,89998560,0,5,0,142
1872,AgenteBasico,89998560,89998560,0,5,0,137
1873,AgenteBasico,89998560,89998560,0,5,0,131
1874,AgenteBasico,89998560,89998555,-5,5,-1,125
1875,AgenteBasico,89998555,89998555,0,5,0,120
1876,AgenteBasico,89998555,89998560,5,5,1,115
1877,AgenteBasico,89998560,89998555,-5,5,-1,109
1878,AgenteBasico,89998555,89998552,-3,0,-1,103
1879,AgenteBasico,89998552,89998557,5,5,1,99
1880,AgenteBasico,89998557,89998562,5,5,1,91
1881,AgenteBasico,89998562,89998557,-5,5,-1,85
1882,AgenteBasico,89998557,89998552,-5,5,-1,79
1883,AgenteBasico,89998552,89998549,-3,0,-1,73
1884,AgenteBasico,89998549,89998546,-3,0,-1,69
1885,AgenteBasico,89998546,89998551,5,5,1,65
1886,AgenteBasico,89998551,89998551,0,5,0,60
1887,AgenteBasico,89998551,89998546,-5,5,-1,55
1888,AgenteBasico,89998546,89998551,5,5,1,49
1889,AgenteBasico,89998551,89998546,-5,5,-1,44
1890,AgenteBasico,89998546,89998543,-3,0,-1,40
1891,AgenteBasico,89998543,89998543,0,10,0,36
1892,AgenteBasico,89998543,89998528,-15,15,-1,202
1893,AgenteBasico,89998528,89998535,7,5,1,194
1894,AgenteBasico,89998535,89998530,-5,5,-1,190
1895,AgenteBasico,89998530,89998530,0,5,0,185
1896,AgenteBasico,89998530,89998525,-5,5,-1,181
1897,AgenteBasico,89998525,89998520,-5,5,-1,176
1898,AgenteBasico,89998520,89998515,-5,5,-1,169
1899,AgenteBasico,89998515,89998510,-5,5,-1,163
1900,AgenteBasico,89998510,89998510,0,5,0,157
1901,AgenteBasico,89998510,89998505,-5,5,-1,150
1902,AgenteBasico,89998505,89998500,-5,5,-1,145
1903,AgenteBasico,89998500,89998510,10,10,1,139
1904,AgenteBasico,89998510,89998510,0,5,0,131
1905,AgenteBasico,89998510,89998505,-5,5,-1,126
1906,AgenteBasico,89998505,89998510,5,5,1,119
1907,AgenteBasico,89998510,89998505,-5,5,-1,113
1908,AgenteBasico,89998505,89998512,7,5,1,107
1909,AgenteBasico,89998512,89998507,-5,5,-1,102
1910,AgenteBasico,89998507,89998502,-5,5,-1,95
1911,AgenteBasico,89998502,89998502,0,5,0,88
1912,AgenteBasico,89998502,89998502,0,5,0,82
1913,AgenteBasico,89998502,89998502,0,5,0,76
1914,AgenteBasico,89998502,89998497,-5,5,-1,72
1915,AgenteBasico,89998497,89998504,7,5,1,67
1916,AgenteBasico,89998504,89998504,0,5,0,63
1917,AgenteBasico,89998504,89998511,7,5,1,57
1918,AgenteBasico,89998511,89998508,-3,0,-1,53
1919,AgenteBasico,89998508,89998503,-5,5,-1,49
1920,AgenteBasico,89998503,89998498,-5,5,-1,43
1921,AgenteBasico,89998498,89998493,-5,5,-1,38
1922,AgenteBasico,89998493,89998488,-5,5,-1,202
1923,AgenteBasico,89998488,89998488,0,5,0,195
1924,AgenteBasico,89998488,89998483,-5,5,-1,190
1925,AgenteBasico,89998483,89998493,10,10,1,186
1926,AgenteBasico,89998493,89998493,0,5,0,178
1927,AgenteBasico,89998493,89998498,5,5,1,173
1928,AgenteBasico,89998498,89998503,5,5,1,167
1929,AgenteBasico,89998503,89998498,-5,5,-1,160
1930,AgenteBasico,89998498,89998508,10,10,1,155
1931,AgenteBasico,89998508,89998513,5,5,1,149
1932,AgenteBasico,89998513,89998513,0,5,0,142
1933,AgenteBasico,89998513,89998513,0,5,0,135
1934,AgenteBasico,89998513,89998518,5,5,1,129
1935,AgenteBasico,89998518,89998513,-5,5,-1,124
1936,AgenteBasico,89998513,89998513,0,5,0,118
1937,AgenteBasico,89998513,89998513,0,5,0,113
1938,AgenteBasico,89998513,89998518,5,5,1,106
1939,AgenteBasico,89998518,89998525,7,5,1,101
1940,AgenteBasico,89998525,89998525,0,5,0,97
1941,AgenteBasico,89998525,89998520,-5,5,-1,92
1942,AgenteBasico,89998520,89998520,0,10,0,87
1943,AgenteBasico,89998520,89998517,-3,0,-1,81
1944,AgenteBasico,89998517,89998517,0,5,0,77
1945,AgenteBasico,89998517,89998512,-5,5,-1,72
1946,AgenteBasico,89998512,89998507,-5,5,-1,68
1947,AgenteBasico,89998507,89998512,5,5,1,63
1948,AgenteBasico,89998512,89998519,7,5,1,58
1949,AgenteBasico,89998519,89998514,-5,5,-1,53
1950,AgenteBasico,89998514,89998509,-5,5,-1,48
1951,AgenteBasico,89998509,89998504,-5,5,-1,203
1952,AgenteBasico,89998504,89998504,0,5,0,198
1953,AgenteBasico,89998504,89998499,-5,5,-1,193
1954,AgenteBasico,89998499,89998504,5,5,1,188
1955,AgenteBasico,89998504,89998511,7,5,1,181
1956,AgenteBasico,89998511,89998506,-5,5,-1,177
1957,AgenteBasico,89998506,89998501,-5,5,-1,171
1958,AgenteBasico,89998501,89998496,-5,5,-1,165
1959,AgenteBasico,89998496,89998491,-5,5,-1,159
1960,AgenteBasico,89998491,89998498,7,5,1,153
1961,AgenteBasico,89998498,89998488,-10,10,-1,148
1962,AgenteBasico,89998488,89998483,-5,5,-1,141
1963,AgenteBasico,89998483,89998478,-5,5,-1,135
1964,AgenteBasico,89998478,89998478,0,10,0,130
1965,AgenteBasico,89998478,89998475,-3,0,-1,123
1966,AgenteBasico,89998475,89998470,-5,5,-1,119
1967,AgenteBasico,89998470,89998470,0,10,0,114
1968,AgenteBasico,89998470,89998475,5,5,1,106
1969,AgenteBasico,89998475,89998480,5,5,1,101
1970,AgenteBasico,89998480,89998475,-5,5,-1,96
1971,AgenteBasico,89998475,89998470,-5,5,-1,92
1972,AgenteBasico,89998470,89998465,-5,5,-1,87
1973,AgenteBasico,89998465,89998465,0,5,0,82
1974,AgenteBasico,89998465,89998470,5,5,1,76
1975,AgenteBasico,89998470,89998470,0,10,0,69
1976,AgenteBasico,89998470,89998465,-5,5,-1,64
1977,AgenteBasico,89998465,89998460,-5,5,-1,59
1978,AgenteBasico,89998460,89998465,5,5,1,53
1979,AgenteBasico,89998465,89998460,-5,5,-1,48
1980,AgenteBasico,89998460,89998460,0,5,0,202
1981,AgenteBasico,89998460,89998465,5,5,1,195
1982,AgenteBasico,89998465,89998460,-5,5,-1,189
1983,AgenteBasico,89998460,89998470,10,10,1,182
1984,AgenteBasico,89998470,89998465,-5,5,-1,175
1985,AgenteBasico,89998465,89998460,-5,5,-1,169
1986,AgenteBasico,89998460,89998465,5,5,1,163
1987,AgenteBasico,89998465,89998460,-5,5,-1,158
1988,AgenteBasico,89998460,89998470,10,10,1,153
1989,AgenteBasico,89998470,89998470,0,5,0,146
1990,AgenteBasico,89998470,89998475,5,5,1,141
1991,AgenteBasico,89998475,89998480,5,5,1,136
1992,AgenteBasico,89998480,89998480,0,5,0,129
1993,AgenteBasico,89998480,89998475,-5,5,-1,125
1994,AgenteBasico,89998475,89998470,-5,5,-1,119
1995,AgenteBasico,89998470,89998477,7,5,1,114
1996,AgenteBasico,89998477,89998472,-5,5,-1,110
1997,AgenteBasico,89998472,89998467,-5,5,-1,102
1998,AgenteBasico,89998467,89998464,-3,0,-1,97
1999,AgenteBasico,89998464,89998464,0,5,0,92
2000,AgenteBasico,89998464,89998454,-10,10,-1,87
2001,AgenteBasico,89998454,89998444,-10,10,-1,81
2002,AgenteBasico,89998444,89998444,0,5,0,76
2003,AgenteBasico,89998444,89998439,-5,5,-1,70
2004,AgenteBasico,89998439,89998436,-3,0,-1,64
2005,AgenteBasico,89998436,89998441,5,5,1,59
2006,AgenteBasico,89998441,89998436,-5,5,-1,54
2007,AgenteBasico,89998436,89998441,5,5,1,50
2008,AgenteBasico,89998441,89998441,0,5,0,44
2009,AgenteBasico,89998441,89998441,0,5,0,201
2010,AgenteBasico,89998441,89998436,-5,5,-1,195
2011,AgenteBasico,89998436,89998431,-5,5,-1,187
2012,AgenteBasico,89998431,89998436,5,5,1,182
2013,AgenteBasico,89998436,89998431,-5,5,-1,177
2014,AgenteBasico,89998431,89998431,0,5,0,170
2015,AgenteBasico,89998431,89998426,-5,5,-1,165
2016,AgenteBasico,89998426,89998421,-5,5,-1,158
2017,AgenteBasico,89998421,89998426,5,5,1,153
2018,AgenteBasico,89998426,89998421,-5,5,-1,148
2019,AgenteBasico,89998421,89998416,-5,5,-1,142
2020,AgenteBasico,89998416,89998413,-3,0,-1,137
2021,AgenteBasico,89998413,89998403,-10,10,-1,132
2022,AgenteBasico,89998403,89998398,-5,5,-1,126
2023,AgenteBasico,89998398,89998393,-5,5,-1,122
2024,AgenteBasico,89998393,89998390,-3,0,-1,116
2025,AgenteBasico,89998390,89998390,0,5,0,112
2026,AgenteBasico,89998390,89998395,5,5,1,108
2027,AgenteBasico,89998395,89998395,0,5,0,101
2028,AgenteBasico,89998395,89998390,-5,5,-1,92
2029,AgenteBasico,89998390,89998390,0,5,0,85
2030,AgenteBasico,89998390,89998385,-5,5,-1,79
2031,AgenteBasico,89998385,89998385,0,5,0,74
2032,AgenteBasico,89998385,89998382,-3,0,-1,69
2033,AgenteBasico,89998382,89998377,-5,5,-1,65
2034,AgenteBasico,89998377,89998372,-5,5,-1,59
2035,AgenteBasico,89998372,89998367,-5,5,-1,53
2036,AgenteBasico,89998367,89998362,-5,5,-1,48
2037,AgenteBasico,89998362,89998362,0,5,0,43
2038,AgenteBasico,89998362,89998362,0,10,0,38
2039,AgenteBasico,89998362,89998369,7,5,1,31
2040,AgenteBasico,89998369,89998364,-5,5,-1,203
2041,AgenteBasico,89998364,89998359,-5,5,-1,198
2042,AgenteBasico,89998359,89998364,5,5,1,191
2043,AgenteBasico,89998364,89998364,0,5,0,185
2044,AgenteBasico,89998364,89998364,0,5,0,180
2045,AgenteBasico,89998364,89998374,10,10,1,176
2046,AgenteBasico,89998374,89998379,5,5,1,170
2047,AgenteBasico,89998379,89998369,-10,10,-1,165
2048,AgenteBasico,89998369,89998359,-10,10,-1,160
2049,AgenteBasico,89998359,89998354,-5,5,-1,154
2050,AgenteBasico,89998354,89998354,0,5,0,148
2051,AgenteBasico,89998354,89998359,5,5,1,142
2052,AgenteBasico,89998359,89998354,-5,5,-1,137
2053,AgenteBasico,89998354,89998359,5,5,1,132
2054,AgenteBasico,89998359,89998359,0,5,0,126
2055,AgenteBasico,89998359,89998359,0,5,0,122
2056,AgenteBasico,89998359,89998354,-5,5,-1,116
2057,AgenteBasico,89998354,89998349,-5,5,-1,110
2058,AgenteBasico,89998349,89998349,0,5,0,104
2059,AgenteBasico,89998349,89998346,-3,0,-1,99
2060,AgenteBasico,89998346,89998353,7,5,1,95
2061,AgenteBasico,89998353,89998358,5,5,1,90
2062,AgenteBasico,89998358,89998345,-13,15,-1,84
2063,AgenteBasico,89998345,89998345,0,5,0,72
2064,AgenteBasico,89998345,89998340,-5,5,-1,67
2065,AgenteBasico,89998340,89998340,0,5,0,61
2066,AgenteBasico,89998340,89998340,0,5,0,57
2067,AgenteBasico,89998340,89998340,0,5,0,52
2068,AgenteBasico,89998340,89998340,0,5,0,48
2069,AgenteBasico,89998340,89998335,-5,5,-1,43
2070,AgenteBasico,89998335,89998342,7,5,1,36
2071,AgenteBasico,89998342,89998357,15,15,1,31
2072,AgenteBasico,89998357,89998352,-5,5,-1,198
2073,AgenteBasico,89998352,89998352,0,5,0,191
2074,AgenteBasico,89998352,89998357,5,5,1,185
2075,AgenteBasico,89998357,89998347,-10,10,-1,179
2076,AgenteBasico,89998347,89998342,-5,5,-1,174
2077,AgenteBasico,89998342,89998347,5,5,1,169
2078,AgenteBasico,89998347,89998347,0,10,0,163
2079,AgenteBasico,89998347,89998352,5,5,1,157
2080,AgenteBasico,89998352,89998347,-5,5,-1,152
2081,AgenteBasico,89998347,89998342,-5,5,-1,147
2082,AgenteBasico,89998342,89998347,5,5,1,143
2083,AgenteBasico,89998347,89998342,-5,5,-1,138
2084,AgenteBasico,89998342,89998339,-3,0,-1,134
2085,AgenteBasico,89998339,89998346,7,5,1,130
2086,AgenteBasico,89998346,89998346,0,5,0,124
2087,AgenteBasico,89998346,89998341,-5,5,-1,119
2088,AgenteBasico,89998341,89998336,-5,15,-1,114
2089,AgenteBasico,89998336,89998336,0,10,0,106
2090,AgenteBasico,89998336,89998331,-5,10,-1,101
2091,AgenteBasico,89998331,89998326,-5,5,-1,94
2092,AgenteBasico,89998326,89998336,10,10,1,89
2093,AgenteBasico,89998336,89998333,-3,0,-1,83
2094,AgenteBasico,89998333,89998333,0,5,0,77
2095,AgenteBasico,89998333,89998333,0,5,0,71
2096,AgenteBasico,89998333,89998328,-5,5,-1,67
2097,AgenteBasico,89998328,89998333,5,5,1,63
2098,AgenteBasico,89998333,89998338,5,5,1,57
2099,AgenteBasico,89998338,89998343,5,5,1,52
2100,AgenteBasico,89998343,89998343,0,5,0,47
2101,AgenteBasico,89998343,89998343,0,5,0,42
2102,AgenteBasico,89998343,89998343,0,5,0,37
2103,AgenteBasico,89998343,89998338,-5,5,-1,31
2104,AgenteBasico,89998338,89998333,-5,5,-1,202
2105,AgenteBasico,89998333,89998343,10,10,1,197
2106,AgenteBasico,89998343,89998333,-10,10,-1,190
2107,AgenteBasico,89998333,89998328,-5,5,-1,184
2108,AgenteBasico,89998328,89998328,0,5,0,180
2109,AgenteBasico,89998328,89998323,-5,5,-1,176
2110,AgenteBasico,89998323,89998333,10,10,1,171
2111,AgenteBasico,89998333,89998328,-5,5,-1,163
2112,AgenteBasico,89998328,89998333,5,5,1,155
2113,AgenteBasico,89998333,89998330,-3,0,-1,149
2114,AgenteBasico,89998330,89998330,0,5,0,143
2115,AgenteBasico,89998330,89998330,0,10,0,137
2116,AgenteBasico,89998330,89998337,7,5,1,132
2117,AgenteBasico,89998337,89998332,-5,5,-1,126
2118,AgenteBasico,89998332,89998337,5,5,1,120
2119,AgenteBasico,89998337,89998334,-3,0,-1,114
2120,AgenteBasico,89998334,89998334,0,5,0,110
2121,AgenteBasico,89998334,89998324,-10,10,-1,105
2122,AgenteBasico,89998324,89998319,-5,5,-1,100
2123,AgenteBasico,89998319,89998326,7,5,1,94
2124,AgenteBasico,89998326,89998321,-5,5,-1,89
2125,AgenteBasico,89998321,89998326,5,5,1,83
2126,AgenteBasico,89998326,89998321,-5,5,-1,76
2127,AgenteBasico,89998321,89998316,-5,5,-1,69
2128,AgenteBasico,89998316,89998311,-5,5,-1,63
2129,AgenteBasico,89998311,89998308,-3,0,-1,59
2130,AgenteBasico,89998308,89998308,0,5,0,54
2131,AgenteBasico,89998308,89998318,10,10,1,50
2132,AgenteBasico,89998318,89998323,5,5,1,202
2133,AgenteBasico,89998323,89998313,-10,10,-1,195
2134,AgenteBasico,89998313,89998318,5,5,1,190
2135,AgenteBasico,89998318,89998325,7,5,1,185
2136,AgenteBasico,89998325,89998320,-5,5,-1,180
2137,AgenteBasico,89998320,89998315,-5,5,-1,175
2138,AgenteBasico,89998315,89998310,-5,5,-1,169
2139,AgenteBasico,89998310,89998310,0,5,0,164
2140,AgenteBasico,89998310,89998305,-5,5,-1,158
2141,AgenteBasico,89998305,89998300,-5,5,-1,153
2142,AgenteBasico,89998300,89998295,-5,5,-1,147
2143,AgenteBasico,89998295,89998300,5,5,1,141
2144,AgenteBasico,89998300,89998297,-3,0,-1,136
2145,AgenteBasico,89998297,89998292,-5,5,-1,132
2146,AgenteBasico,89998292,89998292,0,5,0,126
2147,AgenteBasico,89998292,89998282,-10,10,-1,121
2148,AgenteBasico,89998282,89998272,-10,10,-1,114
2149,AgenteBasico,89998272,89998272,0,5,0,107
2150,AgenteBasico,89998272,89998277,5,5,1,100
2151,AgenteBasico,89998277,89998272,-5,5,-1,93
2152,AgenteBasico,89998272,89998277,5,5,1,89
2153,AgenteBasico,89998277,89998282,5,5,1,84
2154,AgenteBasico,89998282,89998272,-10,10,-1,79
2155,AgenteBasico,89998272,89998267,-5,5,-1,72
2156,AgenteBasico,89998267,89998262,-5,5,-1,66
2157,AgenteBasico,89998262,89998262,0,5,0,61
2158,AgenteBasico,89998262,89998267,5,5,1,56
2159,AgenteBasico,89998267,89998277,10,10,1,50
2160,AgenteBasico,89998277,89998267,-10,10,-1,43
2161,AgenteBasico,89998267,89998262,-5,5,-1,35
2162,AgenteBasico,89998262,89998262,0,10,0,203
2163,AgenteBasico,89998262,89998262,0,5,0,195
2164,AgenteBasico,89998262,89998272,10,10,1,190
2165,AgenteBasico,89998272,89998277,5,5,1,184
2166,AgenteBasico,89998277,89998272,-5,5,-1,179
2167,AgenteBasico,89998272,89998269,-3,0,-1,173
2168,AgenteBasico,89998269,89998259,-10,15,-1,169
2169,AgenteBasico,89998259,89998256,-3,0,-1,161
2170,AgenteBasico,89998256,89998256,0,5,0,156
2171,AgenteBasico,89998256,89998261,5,5,1,149
2172,AgenteBasico,89998261,89998258,-3,0,-1,143
2173,AgenteBasico,89998258,89998253,-5,5,-1,138
2174,AgenteBasico,89998253,89998260,7,5,1,131
2175,AgenteBasico,89998260,89998255,-5,5,-1,126
2176,AgenteBasico,89998255,89998260,5,5,1,120
2177,AgenteBasico,89998260,89998270,10,10,1,112
2178,AgenteBasico,89998270,89998265,-5,5,-1,106
2179,AgenteBasico,89998265,89998270,5,5,1,101
2180,AgenteBasico,89998270,89998270,0,5,0,95
2181,AgenteBasico,89998270,89998270,0,5,0,89
2182,AgenteBasico,89998270,89998265,-5,5,-1,84
2183,AgenteBasico,89998265,89998260,-5,5,-1,78
2184,AgenteBasico,89998260,89998255,-5,5,-1,74
2185,AgenteBasico,89998255,89998250,-5,5,-1,69
2186,AgenteBasico,89998250,89998255,5,5,1,62
2187,AgenteBasico,89998255,89998250,-5,5,-1,56
2188,AgenteBasico,89998250,89998255,5,5,1,50
2189,AgenteBasico,89998255,89998252,-3,0,-1,45
2190,AgenteBasico,89998252,89998247,-5,5,-1,41
2191,AgenteBasico,89998247,89998252,5,5,1,35
2192,AgenteBasico,89998252,89998257,5,5,1,29
2193,AgenteBasico,89998257,89998252,-5,10,-1,203
2194,AgenteBasico,89998252,89998247,-5,5,-1,195
2195,AgenteBasico,89998247,89998247,0,5,0,187
2196,AgenteBasico,89998247,89998247,0,5,0,180
2197,AgenteBasico,89998247,89998257,10,10,1,174
2198,AgenteBasico,89998257,89998252,-5,5,-1,168
2199,AgenteBasico,89998252,89998252,0,5,0,163
2200,AgenteBasico,89998252,89998252,0,5,0,159
2201,AgenteBasico,89998252,89998257,5,5,1,155
2202,AgenteBasico,89998257,89998267,10,10,1,150
2203,AgenteBasico,89998267,89998272,5,5,1,143
2204,AgenteBasico,89998272,89998267,-5,5,-1,138
2205,AgenteBasico,89998267,89998264,-3,0,-1,131
2206,AgenteBasico,89998264,89998271,7,5,1,127
2207,AgenteBasico,89998271,89998261,-10,10,-1,123
2208,AgenteBasico,89998261,89998268,7,5,1,116
2209,AgenteBasico,89998268,89998273,5,5,1,112
2210,AgenteBasico,89998273,89998268,-5,5,-1,107
2211,AgenteBasico,89998268,89998268,0,5,0,99
2212,AgenteBasico,89998268,89998263,-5,5,-1,95
2213,AgenteBasico,89998263,89998263,0,5,0,90
2214,AgenteBasico,89998263,89998263,0,5,0,86
2215,AgenteBasico,89998263,89998263,0,5,0,82
2216,AgenteBasico,89998263,89998258,-5,5,-1,76
2217,AgenteBasico,89998258,89998258,0,5,0,71
2218,AgenteBasico,89998258,89998263,5,5,1,66
2219,AgenteBasico,89998263,89998268,5,5,1,61
2220,AgenteBasico,89998268,89998263,-5,5,-1,54
2221,AgenteBasico,89998263,89998258,-5,5,-1,47
2222,AgenteBasico,89998258,89998253,-5,5,-1,39
2223,AgenteBasico,89998253,89998248,-5,5,-1,203
2224,AgenteBasico,89998248,89998245,-3,0,-1,197
2225,AgenteBasico,89998245,89998240,-5,5,-1,192
2226,AgenteBasico,89998240,89998235,-5,5,-1,187
2227,AgenteBasico,89998235,89998240,5,5,1,182
2228,AgenteBasico,89998240,89998240,0,5,0,176
2229,AgenteBasico,89998240,89998250,10,10,1,169
2230,AgenteBasico,89998250,89998255,5,5,1,163
2231,AgenteBasico,89998255,89998260,5,5,1,156
2232,AgenteBasico,89998260,89998265,5,5,1,151
2233,AgenteBasico,89998265,89998265,0,5,0,146
2234,AgenteBasico,89998265,89998260,-5,5,-1,140
2235,AgenteBasico,89998260,89998265,5,5,1,135
2236,AgenteBasico,89998265,89998272,7,5,1,130
2237,AgenteBasico,89998272,89998269,-3,0,-1,124
2238,AgenteBasico,89998269,89998264,-5,5,-1,120
2239,AgenteBasico,89998264,89998271,7,5,1,114
2240,AgenteBasico,89998271,89998271,0,5,0,109
2241,AgenteBasico,89998271,89998266,-5,5,-1,103
2242,AgenteBasico,89998266,89998261,-5,5,-1,96
2243,AgenteBasico,89998261,89998256,-5,5,-1,92
2244,AgenteBasico,89998256,89998251,-5,5,-1,86
2245,AgenteBasico,89998251,89998246,-5,5,-1,80
2246,AgenteBasico,89998246,89998241,-5,5,-1,71
2247,AgenteBasico,89998241,89998236,-5,5,-1,65
2248,AgenteBasico,89998236,89998231,-5,5,-1,58
2249,AgenteBasico,89998231,89998226,-5,5,-1,52
2250,AgenteBasico,89998226,89998233,7,5,1,47
2251,AgenteBasico,89998233,89998228,-5,5,-1,42
2252,AgenteBasico,89998228,89998233,5,5,1,201
2253,AgenteBasico,89998233,89998228,-5,5,-1,194
2254,AgenteBasico,89998228,89998228,0,10,0,190
2255,AgenteBasico,89998228,89998223,-5,5,-1,184
2256,AgenteBasico,89998223,89998228,5,5,1,176
2257,AgenteBasico,89998228,89998228,0,5,0,168
2258,AgenteBasico,89998228,89998233,5,5,1,162
2259,AgenteBasico,89998233,89998238,5,5,1,156
2260,AgenteBasico,89998238,89998235,-3,0,-1,151
2261,AgenteBasico,89998235,89998225,-10,10,-1,146
2262,AgenteBasico,89998225,89998222,-3,0,-1,139
2263,AgenteBasico,89998222,89998222,0,5,0,134
2264,AgenteBasico,89998222,89998217,-5,5,-1,128
2265,AgenteBasico,89998217,89998212,-5,5,-1,123
2266,AgenteBasico,89998212,89998207,-5,5,-1,118
2267,AgenteBasico,89998207,89998212,5,5,1,113
2268,AgenteBasico,89998212,89998222,10,10,1,107
2269,AgenteBasico,89998222,89998217,-5,5,-1,100
2270,AgenteBasico,89998217,89998212,-5,5,-1,95
2271,AgenteBasico,89998212,89998219,7,5,1,89
2272,AgenteBasico,89998219,89998214,-5,5,-1,84
2273,AgenteBasico,89998214,89998219,5,5,1,78
2274,AgenteBasico,89998219,89998214,-5,5,-1,73
2275,AgenteBasico,89998214,89998219,5,5,1,66
2276,AgenteBasico,89998219,89998214,-5,5,-1,60
2277,AgenteBasico,89998214,89998214,0,5,0,55
2278,AgenteBasico,89998214,89998209,-5,5,-1,51
2279,AgenteBasico,89998209,89998204,-5,5,-1,46
2280,AgenteBasico,89998204,89998199,-5,5,-1,202
2281,AgenteBasico,89998199,89998194,-5,5,-1,197
2282,AgenteBasico,89998194,89998189,-5,5,-1,192
2283,AgenteBasico,89998189,89998189,0,5,0,187
2284,AgenteBasico,89998189,89998194,5,5,1,182
2285,AgenteBasico,89998194,89998194,0,5,0,175
2286,AgenteBasico,89998194,89998201,7,5,1,170
2287,AgenteBasico,89998201,89998206,5,5,1,163
2288,AgenteBasico,89998206,89998211,5,5,1,156
2289,AgenteBasico,89998211,89998206,-5,5,-1,151
2290,AgenteBasico,89998206,89998201,-5,5,-1,145
2291,AgenteBasico,89998201,89998206,5,5,1,140
2292,AgenteBasico,89998206,89998203,-3,0,-1,135
2293,AgenteBasico,89998203,89998198,-5,5,-1,131
2294,AgenteBasico,89998198,89998198,0,5,0,125
2295,AgenteBasico,89998198,89998208,10,10,1,120
2296,AgenteBasico,89998208,89998203,-5,5,-1,112
2297,AgenteBasico,89998203,89998203,0,10,0,108
2298,AgenteBasico,89998203,89998198,-5,5,-1,102
2299,AgenteBasico,89998198,89998193,-5,5,-1,97
2300,AgenteBasico,89998193,89998188,-5,5,-1,92
2301,AgenteBasico,89998188,89998183,-5,5,-1,87
2302,AgenteBasico,89998183,89998178,-5,5,-1,81
2303,AgenteBasico,89998178,89998178,0,5,0,75
2304,AgenteBasico,89998178,89998173,-5,5,-1,67
2305,AgenteBasico,89998173,89998168,-5,5,-1,61
2306,AgenteBasico,89998168,89998163,-5,5,-1,55
2307,AgenteBasico,89998163,89998168,5,5,1,49
2308,AgenteBasico,89998168,89998168,0,10,0,201
2309,AgenteBasico,89998168,89998163,-5,5,-1,195
2310,AgenteBasico,89998163,89998153,-10,10,-1,188
2311,AgenteBasico,89998153,89998153,0,5,0,183
2312,AgenteBasico,89998153,89998153,0,5,0,178
2313,AgenteBasico,89998153,89998153,0,5,0,174
2314,AgenteBasico,89998153,89998150,-3,0,-1,170
2315,AgenteBasico,89998150,89998155,5,5,1,166
2316,AgenteBasico,89998155,89998155,0,5,0,161
2317,AgenteBasico,89998155,89998155,0,5,0,156
2318,AgenteBasico,89998155,89998150,-5,5,-1,150
2319,AgenteBasico,89998150,89998145,-5,5,-1,145
2320,AgenteBasico,89998145,89998140,-5,5,-1,140
2321,AgenteBasico,89998140,89998140,0,5,0,135
2322,AgenteBasico,89998140,89998135,-5,5,-1,130
2323,AgenteBasico,89998135,89998125,-10,10,-1,125
2324,AgenteBasico,89998125,89998115,-10,10,-1,119
2325,AgenteBasico,89998115,89998115,0,5,0,113
2326,AgenteBasico,89998115,89998120,5,5,1,108
2327,AgenteBasico,89998120,89998120,0,5,0,102
2328,AgenteBasico,89998120,89998125,5,5,1,96
2329,AgenteBasico,89998125,89998120,-5,5,-1,90
2330,AgenteBasico,89998120,89998115,-5,5,-1,85
2331,AgenteBasico,89998115,89998110,-5,5,-1,80
2332,AgenteBasico,89998110,89998115,5,5,1,74
2333,AgenteBasico,89998115,89998115,0,5,0,67
2334,AgenteBasico,89998115,89998110,-5,5,-1,61
2335,AgenteBasico,89998110,89998110,0,5,0,57
2336,AgenteBasico,89998110,89998110,0,5,0,53
2337,AgenteBasico,89998110,89998117,7,5,1,49
2338,AgenteBasico,89998117,89998112,-5,5,-1,45
2339,AgenteBasico,89998112,89998107,-5,5,-1,41
2340,AgenteBasico,89998107,89998102,-5,5,-1,36
2341,AgenteBasico,89998102,89998097,-5,5,-1,203
2342,AgenteBasico,89998097,89998094,-3,0,-1,196
2343,AgenteBasico,89998094,89998084,-10,10,-1,192
2344,AgenteBasico,89998084,89998084,0,5,0,186
2345,AgenteBasico,89998084,89998084,0,5,0,181
2346,AgenteBasico,89998084,89998094,10,10,1,176
2347,AgenteBasico,89998094,89998089,-5,5,-1,170
2348,AgenteBasico,89998089,89998089,0,5,0,165
2349,AgenteBasico,89998089,89998089,0,5,0,161
2350,AgenteBasico,89998089,89998084,-5,5,-1,155
2351,AgenteBasico,89998084,89998091,7,5,1,151
2352,AgenteBasico,89998091,89998096,5,5,1,146
2353,AgenteBasico,89998096,89998091,-5,5,-1,141
2354,AgenteBasico,89998091,89998086,-5,5,-1,137
2355,AgenteBasico,89998086,89998086,0,5,0,131
2356,AgenteBasico,89998086,89998081,-5,5,-1,125
2357,AgenteBasico,89998081,89998076,-5,5,-1,120
2358,AgenteBasico,89998076,89998071,-5,5,-1,115
2359,AgenteBasico,89998071,89998081,10,10,1,110
2360,AgenteBasico,89998081,89998086,5,5,1,104
2361,AgenteBasico,89998086,89998086,0,10,0,97
2362,AgenteBasico,89998086,89998081,-5,5,-1,86
2363,AgenteBasico,89998081,89998076,-5,5,-1,81
2364,AgenteBasico,89998076,89998076,0,5,0,76
2365,AgenteBasico,89998076,89998083,7,5,1,69
2366,AgenteBasico,89998083,89998088,5,5,1,65
2367,AgenteBasico,89998088,89998095,7,5,1,60
2368,AgenteBasico,89998095,89998095,0,5,0,55
2369,AgenteBasico,89998095,89998090,-5,5,-1,47
2370,AgenteBasico,89998090,89998090,0,5,0,41
2371,AgenteBasico,89998090,89998085,-5,5,-1,36
2372,AgenteBasico,89998085,89998080,-5,5,-1,31
2373,AgenteBasico,89998080,89998080,0,5,0,199
2374,AgenteBasico,89998080,89998080,0,5,0,195
2375,AgenteBasico,89998080,89998075,-5,5,-1,190
2376,AgenteBasico,89998075,89998080,5,5,1,183
2377,AgenteBasico,89998080,89998075,-5,5,-1,178
2378,AgenteBasico,89998075,89998070,-5,5,-1,173
2379,AgenteBasico,89998070,89998065,-5,5,-1,168
2380,AgenteBasico,89998065,89998065,0,5,0,163
2381,AgenteBasico,89998065,89998075,10,10,1,158
2382,AgenteBasico,89998075,89998075,0,5,0,152
2383,AgenteBasico,89998075,89998070,-5,5,-1,147
2384,AgenteBasico,89998070,89998077,7,5,1,142
2385,AgenteBasico,89998077,89998077,0,5,0,137
2386,AgenteBasico,89998077,89998077,0,5,0,133
2387,AgenteBasico,89998077,89998072,-5,5,-1,128
2388,AgenteBasico,89998072,89998082,10,10,1,123
2389,AgenteBasico,89998082,89998082,0,5,0,116
2390,AgenteBasico,89998082,89998089,7,5,1,111
2391,AgenteBasico,89998089,89998084,-5,5,-1,107
2392,AgenteBasico,89998084,89998079,-5,5,-1,99
2393,AgenteBasico,89998079,89998074,-5,5,-1,95
2394,AgenteBasico,89998074,89998069,-5,5,-1,90
2395,AgenteBasico,89998069,89998074,5,5,1,84
2396,AgenteBasico,89998074,89998069,-5,5,-1,79
2397,AgenteBasico,89998069,89998069,0,5,0,74
2398,AgenteBasico,89998069,89998064,-5,5,-1,69
2399,AgenteBasico,89998064,89998059,-5,5,-1,65
2400,AgenteBasico,89998059,89998054,-5,5,-1,60
2401,AgenteBasico,89998054,89998049,-5,5,-1,55
2402,AgenteBasico,89998049,89998054,5,5,1,51
2403,AgenteBasico,89998054,89998059,5,5,1,45
2404,AgenteBasico,89998059,89998054,-5,5,-1,37
2405,AgenteBasico,89998054,89998049,-5,5,-1,202
2406,AgenteBasico,89998049,89998049,0,10,0,195
2407,AgenteBasico,89998049,89998054,5,5,1,189
2408,AgenteBasico,89998054,89998059,5,5,1,182
2409,AgenteBasico,89998059,89998059,0,5,0,176
2410,AgenteBasico,89998059,89998064,5,5,1,172
2411,AgenteBasico,89998064,89998059,-5,5,-1,166
2412,AgenteBasico,89998059,89998059,0,5,0,161
2413,AgenteBasico,89998059,89998059,0,5,0,157
2414,AgenteBasico,89998059,89998064,5,5,1,152
2415,AgenteBasico,89998064,89998059,-5,5,-1,144
2416,AgenteBasico,89998059,89998059,0,5,0,140
2417,AgenteBasico,89998059,89998054,-5,5,-1,135
2418,AgenteBasico,89998054,89998049,-5,5,-1,130
2419,AgenteBasico,89998049,89998044,-5,5,-1,123
2420,AgenteBasico,89998044,89998044,0,5,0,118
2421,AgenteBasico,89998044,89998039,-5,5,-1,112
2422,AgenteBasico,89998039,89998034,-5,5,-1,106
2423,AgenteBasico,89998034,89998034,0,10,0,101
2424,AgenteBasico,89998034,89998029,-5,5,-1,95
2425,AgenteBasico,89998029,89998024,-5,5,-1,90
2426,AgenteBasico,89998024,89998019,-5,5,-1,84
2427,AgenteBasico,89998019,89998026,7,5,1,79
2428,AgenteBasico,89998026,89998021,-5,5,-1,73
2429,AgenteBasico,89998021,89998031,10,10,1,68
2430,AgenteBasico,89998031,89998026,-5,5,-1,59
2431,AgenteBasico,89998026,89998023,-3,0,-1,54
2432,AgenteBasico,89998023,89998023,0,5,0,50
2433,AgenteBasico,89998023,89998028,5,5,1,45
2434,AgenteBasico,89998028,89998033,5,5,1,203
2435,AgenteBasico,89998033,89998033,0,5,0,198
2436,AgenteBasico,89998033,89998028,-5,5,-1,193
2437,AgenteBasico,89998028,89998023,-5,5,-1,188
2438,AgenteBasico,89998023,89998020,-3,0,-1,181
2439,AgenteBasico,89998020,89998017,-3,0,-1,177
2440,AgenteBasico,89998017,89998022,5,5,1,173
2441,AgenteBasico,89998022,89998027,5,5,1,165
2442,AgenteBasico,89998027,89998022,-5,5,-1,158
2443,AgenteBasico,89998022,89998022,0,5,0,152
2444,AgenteBasico,89998022,89998022,0,10,0,147
2445,AgenteBasico,89998022,89998029,7,5,1,142
2446,AgenteBasico,89998029,89998029,0,5,0,138
2447,AgenteBasico,89998029,89998039,10,10,1,134
2448,AgenteBasico,89998039,89998039,0,5,0,127
2449,AgenteBasico,89998039,89998046,7,5,1,123
2450,AgenteBasico,89998046,89998041,-5,5,-1,118
2451,AgenteBasico,89998041,89998036,-5,5,-1,112
2452,AgenteBasico,89998036,89998031,-5,5,-1,107
2453,AgenteBasico,89998031,89998036,5,5,1,99
2454,AgenteBasico,89998036,89998036,0,5,0,94
2455,AgenteBasico,89998036,89998031,-5,5,-1,90
2456,AgenteBasico,89998031,89998036,5,5,1,86
2457,AgenteBasico,89998036,89998026,-10,10,-1,79
2458,AgenteBasico,89998026,89998031,5,5,1,72
2459,AgenteBasico,89998031,89998028,-3,0,-1,66
2460,AgenteBasico,89998028,89998033,5,5,1,62
2461,AgenteBasico,89998033,89998028,-5,5,-1,57
2462,AgenteBasico,89998028,89998035,7,5,1,51
2463,AgenteBasico,89998035,89998035,0,5,0,46
2464,AgenteBasico,89998035,89998035,0,10,0,203
2465,AgenteBasico,89998035,89998030,-5,5,-1,198
2466,AgenteBasico,89998030,89998035,5,5,1,192
2467,AgenteBasico,89998035,89998030,-5,5,-1,187
2468,AgenteBasico,89998030,89998035,5,5,1,182
2469,AgenteBasico,89998035,89998035,0,5,0,176
2470,AgenteBasico,89998035,89998035,0,5,0,169
2471,AgenteBasico,89998035,89998030,-5,5,-1,161
2472,AgenteBasico,89998030,89998025,-5,5,-1,156
2473,AgenteBasico,89998025,89998025,0,5,0,151
2474,AgenteBasico,89998025,89998030,5,5,1,146
2475,AgenteBasico,89998030,89998030,0,5,0,141
2476,AgenteBasico,89998030,89998037,7,5,1,136
2477,AgenteBasico,89998037,89998032,-5,5,-1,131
2478,AgenteBasico,89998032,89998037,5,5,1,125
2479,AgenteBasico,89998037,89998042,5,5,1,118
2480,AgenteBasico,89998042,89998037,-5,5,-1,113
2481,AgenteBasico,89998037,89998042,5,5,1,107
2482,AgenteBasico,89998042,89998037,-5,5,-1,101
2483,AgenteBasico,89998037,89998042,5,5,1,94
2484,AgenteBasico,89998042,89998039,-3,0,-1,89
2485,AgenteBasico,89998039,89998044,5,5,1,85
2486,AgenteBasico,89998044,89998039,-5,5,-1,79
2487,AgenteBasico,89998039,89998039,0,5,0,72
2488,AgenteBasico,89998039,89998044,5,5,1,67
2489,AgenteBasico,89998044,89998051,7,5,1,62
2490,AgenteBasico,89998051,89998056,5,5,1,57
2491,AgenteBasico,89998056,89998056,0,5,0,50
2492,AgenteBasico,89998056,89998051,-5,5,-1,202
2493,AgenteBasico,89998051,89998046,-5,5,-1,195
2494,AgenteBasico,89998046,89998046,0,5,0,189
2495,AgenteBasico,89998046,89998041,-5,5,-1,185
2496,AgenteBasico,89998041,89998036,-5,5,-1,180
2497,AgenteBasico,89998036,89998031,-5,5,-1,174
2498,AgenteBasico,89998031,89998028,-3,0,-1,168
2499,AgenteBasico,89998028,89998023,-5,5,-1,164
2500,AgenteBasico,89998023,89998013,-10,10,-1,160
2501,AgenteBasico,89998013,89998010,-3,0,-1,154
2502,AgenteBasico,89998010,89998017,7,5,1,150
2503,AgenteBasico,89998017,89998012,-5,5,-1,143
2504,AgenteBasico,89998012,89998017,5,5,1,136
2505,AgenteBasico,89998017,89998012,-5,5,-1,131
2506,AgenteBasico,89998012,89998007,-5,5,-1,125
2507,AgenteBasico,89998007,89998002,-5,5,-1,120
2508,AgenteBasico,89998002,89997992,-10,10,-1,114
2509,AgenteBasico,89997992,89997997,5,5,1,108
2510,AgenteBasico,89997997,89997987,-10,10,-1,103
2511,AgenteBasico,89997987,89997992,5,5,1,98
2512,AgenteBasico,89997992,89997999,7,5,1,93
2513,AgenteBasico,89997999,89997994,-5,5,-1,89
2514,AgenteBasico,89997994,89997999,5,5,1,84
2515,AgenteBasico,89997999,89997994,-5,5,-1,79
2516,AgenteBasico,89997994,89998004,10,10,1,73
2517,AgenteBasico,89998004,89998014,10,10,1,67
2518,AgenteBasico,89998014,89998009,-5,5,-1,60
2519,AgenteBasico,89998009,89998009,0,10,0,54
2520,AgenteBasico,89998009,89998009,0,5,0,48
2521,AgenteBasico,89998009,89998004,-5,5,-1,43
2522,AgenteBasico,89998004,89998004,0,10,0,38
2523,AgenteBasico,89998004,89998009,5,5,1,33
2524,AgenteBasico,89998009,89998009,0,5,0,27
2525,AgenteBasico,89998009,89998009,0,5,0,203
2526,AgenteBasico,89998009,89998004,-5,5,-1,199
2527,AgenteBasico,89998004,89998004,0,5,0,194
2528,AgenteBasico,89998004,89998004,0,5,0,188
2529,AgenteBasico,89998004,89997994,-10,10,-1,184
2530,AgenteBasico,89997994,89997991,-3,0,-1,179
2531,AgenteBasico,89997991,89997991,0,10,0,175
2532,AgenteBasico,89997991,89997996,5,5,1,169
2533,AgenteBasico,89997996,89998001,5,5,1,163
2534,AgenteBasico,89998001,89997996,-5,5,-1,156
2535,AgenteBasico,89997996,89997991,-5,5,-1,149
2536,AgenteBasico,89997991,89997986,-5,5,-1,144
2537,AgenteBasico,89997986,89997981,-5,5,-1,138
2538,AgenteBasico,89997981,89997981,0,5,0,132
2539,AgenteBasico,89997981,89997976,-5,5,-1,128
2540,AgenteBasico,89997976,89997976,0,5,0,122
2541,AgenteBasico,89997976,89997971,-5,5,-1,117
2542,AgenteBasico,89997971,89997976,5,5,1,112
2543,AgenteBasico,89997976,89997986,10,20,1,106
2544,AgenteBasico,89997986,89997986,0,5,0,94
2545,AgenteBasico,89997986,89997976,-10,10,-1,88
2546,AgenteBasico,89997976,89997976,0,5,0,83
2547,AgenteBasico,89997976,89997976,0,5,0,78
2548,AgenteBasico,89997976,89997971,-5,5,-1,72
2549,AgenteBasico,89997971,89997971,0,5,0,66
2550,AgenteBasico,89997971,89997976,5,5,1,61
2551,AgenteBasico,89997976,89997971,-5,5,-1,56
2552,AgenteBasico,89997971,89997971,0,5,0,49
2553,AgenteBasico,89997971,89997966,-5,5,-1,202
2554,AgenteBasico,89997966,89997971,5,5,1,198
2555,AgenteBasico,89997971,89997966,-5,5,-1,191
2556,AgenteBasico,89997966,89997961,-5,5,-1,186
2557,AgenteBasico,89997961,89997961,0,10,0,181
2558,AgenteBasico,89997961,89997956,-5,5,-1,175
2559,AgenteBasico,89997956,89997951,-5,5,-1,170
2560,AgenteBasico,89997951,89997946,-5,5,-1,165
2561,AgenteBasico,89997946,89997946,0,5,0,159
2562,AgenteBasico,89997946,89997953,7,5,1,155
2563,AgenteBasico,89997953,89997948,-5,5,-1,150
2564,AgenteBasico,89997948,89997958,10,10,1,145
2565,AgenteBasico,89997958,89997958,0,5,0,139
2566,AgenteBasico,89997958,89997948,-10,10,-1,134
2567,AgenteBasico,89997948,89997943,-5,5,-1,128
2568,AgenteBasico,89997943,89997943,0,5,0,124
2569,AgenteBasico,89997943,89997943,0,5,0,118
2570,AgenteBasico,89997943,89997938,-5,5,-1,114
2571,AgenteBasico,89997938,89997933,-5,5,-1,109
2572,AgenteBasico,89997933,89997933,0,5,0,102
2573,AgenteBasico,89997933,89997928,-5,10,-1,97
2574,AgenteBasico,89997928,89997928,0,5,0,88
2575,AgenteBasico,89997928,89997923,-5,5,-1,82
2576,AgenteBasico,89997923,89997928,5,5,1,78
2577,AgenteBasico,89997928,89997933,5,5,1,72
2578,AgenteBasico,89997933,89997928,-5,5,-1,67
2579,AgenteBasico,89997928,89997923,-5,5,-1,61
2580,AgenteBasico,89997923,89997930,7,5,1,55
2581,AgenteBasico,89997930,89997925,-5,5,-1,50
2582,AgenteBasico,89997925,89997920,-5,5,-1,42
2583,AgenteBasico,89997920,89997925,5,5,1,202
2584,AgenteBasico,89997925,89997925,0,5,0,197
2585,AgenteBasico,89997925,89997925,0,5,0,193
2586,AgenteBasico,89997925,89997925,0,5,0,186
2587,AgenteBasico,89997925,89997920,-5,5,-1,181
2588,AgenteBasico,89997920,89997920,0,5,0,177
2589,AgenteBasico,89997920,89997915,-5,5,-1,173
2590,AgenteBasico,89997915,89997920,5,5,1,165
2591,AgenteBasico,89997920,89997915,-5,5,-1,159
2592,AgenteBasico,89997915,89997905,-10,10,-1,152
2593,AgenteBasico,89997905,89997900,-5,5,-1,145
2594,AgenteBasico,89997900,89997905,5,5,1,139
2595,AgenteBasico,89997905,89997905,0,5,0,132
2596,AgenteBasico,89997905,89997905,0,5,0,126
2597,AgenteBasico,89997905,89997905,0,5,0,122
2598,AgenteBasico,89997905,89997915,10,10,1,117
2599,AgenteBasico,89997915,89997910,-5,5,-1,111
2600,AgenteBasico,89997910,89997920,10,10,1,103
2601,AgenteBasico,89997920,89997917,-3,0,-1,97
2602,AgenteBasico,89997917,89997912,-5,15,-1,93
2603,AgenteBasico,89997912,89997917,5,5,1,85
2604,AgenteBasico,89997917,89997917,0,10,0,79
2605,AgenteBasico,89997917,89997927,10,10,1,74
2606,AgenteBasico,89997927,89997922,-5,5,-1,68
2607,AgenteBasico,89997922,89997927,5,5,1,61
2608,AgenteBasico,89997927,89997932,5,5,1,56
2609,AgenteBasico,89997932,89997927,-5,5,-1,51
2610,AgenteBasico,89997927,89997937,10,10,1,46
2611,AgenteBasico,89997937,89997932,-5,5,-1,39
2612,AgenteBasico,89997932,89997932,0,5,0,34
2613,AgenteBasico,89997932,89997929,-3,0,-1,201
2614,AgenteBasico,89997929,89997919,-10,10,-1,196
2615,AgenteBasico,89997919,89997924,5,5,1,191
2616,AgenteBasico,89997924,89997924,0,10,0,185
2617,AgenteBasico,89997924,89997919,-5,5,-1,180
2618,AgenteBasico,89997919,89997914,-5,5,-1,174
2619,AgenteBasico,89997914,89997904,-10,10,-1,167
2620,AgenteBasico,89997904,89997911,7,5,1,157
2621,AgenteBasico,89997911,89997906,-5,5,-1,153
2622,AgenteBasico,89997906,89997901,-5,5,-1,149
2623,AgenteBasico,89997901,89997896,-5,5,-1,145
2624,AgenteBasico,89997896,89997891,-5,5,-1,138
2625,AgenteBasico,89997891,89997886,-5,5,-1,133
2626,AgenteBasico,89997886,89997886,0,10,0,127
2627,AgenteBasico,89997886,89997891,5,5,1,121
2628,AgenteBasico,89997891,89997886,-5,5,-1,116
2629,AgenteBasico,89997886,89997891,5,5,1,111
2630,AgenteBasico,89997891,89997886,-5,5,-1,106
2631,AgenteBasico,89997886,89997886,0,5,0,100
2632,AgenteBasico,89997886,89997886,0,5,0,95
2633,AgenteBasico,89997886,89997881,-5,5,-1,88
2634,AgenteBasico,89997881,89997878,-3,0,-1,79
2635,AgenteBasico,89997878,89997883,5,5,1,74
2636,AgenteBasico,89997883,89997878,-5,5,-1,69
2637,AgenteBasico,89997878,89997883,5,5,1,64
2638,AgenteBasico,89997883,89997883,0,10,0,59
2639,AgenteBasico,89997883,89997878,-5,5,-1,52
2640,AgenteBasico,89997878,89997873,-5,5,-1,47
2641,AgenteBasico,89997873,89997868,-5,5,-1,203
2642,AgenteBasico,89997868,89997873,5,5,1,198
2643,AgenteBasico,89997873,89997878,5,5,1,192
2644,AgenteBasico,89997878,89997878,0,5,0,187
2645,AgenteBasico,89997878,89997878,0,5,0,182
2646,AgenteBasico,89997878,89997873,-5,5,-1,177
2647,AgenteBasico,89997873,89997873,0,10,0,170
2648,AgenteBasico,89997873,89997883,10,10,1,164
2649,AgenteBasico,89997883,89997878,-5,5,-1,158
2650,AgenteBasico,89997878,89997873,-5,5,-1,151
2651,AgenteBasico,89997873,89997868,-5,5,-1,145
2652,AgenteBasico,89997868,89997863,-5,5,-1,140
2653,AgenteBasico,89997863,89997863,0,5,0,136
2654,AgenteBasico,89997863,89997858,-5,5,-1,131
2655,AgenteBasico,89997858,89997855,-3,0,-1,125
2656,AgenteBasico,89997855,89997860,5,5,1,121
2657,AgenteBasico,89997860,89997865,5,5,1,114
2658,AgenteBasico,89997865,89997860,-5,5,-1,109
2659,AgenteBasico,89997860,89997855,-5,5,-1,104
2660,AgenteBasico,89997855,89997855,0,5,0,99
2661,AgenteBasico,89997855,89997850,-5,5,-1,93
2662,AgenteBasico,89997850,89997855,5,5,1,88
2663,AgenteBasico,89997855,89997865,10,10,1,82
2664,AgenteBasico,89997865,89997865,0,5,0,76
2665,AgenteBasico,89997865,89997860,-5,5,-1,70
2666,AgenteBasico,89997860,89997855,-5,5,-1,66
2667,AgenteBasico,89997855,89997850,-5,5,-1,61
2668,AgenteBasico,89997850,89997845,-5,5,-1,57
2669,AgenteBasico,89997845,89997840,-5,10,-1,49
2670,AgenteBasico,89997840,89997845,5,5,1,201
2671,AgenteBasico,89997845,89997840,-5,5,-1,195
2672,AgenteBasico,89997840,89997835,-5,5,-1,187
2673,AgenteBasico,89997835,89997830,-5,5,-1,181
2674,AgenteBasico,89997830,89997835,5,5,1,175
2675,AgenteBasico,89997835,89997835,0,5,0,168
2676,AgenteBasico,89997835,89997840,5,5,1,163
2677,AgenteBasico,89997840,89997835,-5,5,-1,157
2678,AgenteBasico,89997835,89997830,-5,5,-1,152
2679,AgenteBasico,89997830,89997827,-3,0,-1,146
2680,AgenteBasico,89997827,89997824,-3,0,-1,142
2681,AgenteBasico,89997824,89997819,-5,5,-1,136
2682,AgenteBasico,89997819,89997814,-5,5,-1,132
2683,AgenteBasico,89997814,89997809,-5,5,-1,126
2684,AgenteBasico,89997809,89997814,5,5,1,120
2685,AgenteBasico,89997814,89997809,-5,5,-1,114
2686,AgenteBasico,89997809,89997804,-5,5,-1,110
2687,AgenteBasico,89997804,89997799,-5,5,-1,104
2688,AgenteBasico,89997799,89997809,10,10,1,99
2689,AgenteBasico,89997809,89997814,5,5,1,92
2690,AgenteBasico,89997814,89997809,-5,5,-1,85
2691,AgenteBasico,89997809,89997806,-3,0,-1,79
2692,AgenteBasico,89997806,89997796,-10,10,-1,73
2693,AgenteBasico,89997796,89997791,-5,5,-1,68
2694,AgenteBasico,89997791,89997791,0,10,0,63
2695,AgenteBasico,89997791,89997801,10,10,1,57
2696,AgenteBasico,89997801,89997806,5,5,1,51
2697,AgenteBasico,89997806,89997811,5,5,1,45
2698,AgenteBasico,89997811,89997806,-5,5,-1,203
2699,AgenteBasico,89997806,89997801,-5,5,-1,198
2700,AgenteBasico,89997801,89997806,5,5,1,193
2701,AgenteBasico,89997806,89997811,5,5,1,185
2702,AgenteBasico,89997811,89997806,-5,5,-1,177
2703,AgenteBasico,89997806,89997801,-5,5,-1,171
2704,AgenteBasico,89997801,89997796,-5,5,-1,166
2705,AgenteBasico,89997796,89997796,0,5,0,159
2706,AgenteBasico,89997796,89997791,-5,5,-1,154
2707,AgenteBasico,89997791,89997786,-5,5,-1,149
2708,AgenteBasico,89997786,89997781,-5,5,-1,143
2709,AgenteBasico,89997781,89997786,5,5,1,137
2710,AgenteBasico,89997786,89997786,0,5,0,130
2711,AgenteBasico,89997786,89997781,-5,5,-1,125
2712,AgenteBasico,89997781,89997781,0,5,0,117
2713,AgenteBasico,89997781,89997776,-5,5,-1,113
2714,AgenteBasico,89997776,89997771,-5,5,-1,109
2715,AgenteBasico,89997771,89997766,-5,5,-1,103
2716,AgenteBasico,89997766,89997761,-5,5,-1,97
2717,AgenteBasico,89997761,89997761,0,5,0,91
2718,AgenteBasico,89997761,89997756,-5,5,-1,86
2719,AgenteBasico,89997756,89997753,-3,0,-1,81
2720,AgenteBasico,89997753,89997748,-5,5,-1,77
2721,AgenteBasico,89997748,89997748,0,5,0,72
2722,AgenteBasico,89997748,89997753,5,5,1,67
2723,AgenteBasico,89997753,89997748,-5,5,-1,61
2724,AgenteBasico,89997748,89997745,-3,0,-1,55
2725,AgenteBasico,89997745,89997745,0,10,0,51
2726,AgenteBasico,89997745,89997740,-5,5,-1,202
2727,AgenteBasico,89997740,89997735,-5,5,-1,196
2728,AgenteBasico,89997735,89997730,-5,5,-1,191
2729,AgenteBasico,89997730,89997730,0,5,0,186
2730,AgenteBasico,89997730,89997735,5,5,1,180
2731,AgenteBasico,89997735,89997730,-5,5,-1,174
2732,AgenteBasico,89997730,89997730,0,5,0,170
2733,AgenteBasico,89997730,89997720,-10,10,-1,166
2734,AgenteBasico,89997720,89997715,-5,5,-1,160
2735,AgenteBasico,89997715,89997715,0,5,0,154
2736,AgenteBasico,89997715,89997705,-10,10,-1,150
2737,AgenteBasico,89997705,89997705,0,5,0,144
2738,AgenteBasico,89997705,89997700,-5,5,-1,139
2739,AgenteBasico,89997700,89997695,-5,5,-1,133
2740,AgenteBasico,89997695,89997685,-10,10,-1,127
2741,AgenteBasico,89997685,89997680,-5,5,-1,121
2742,AgenteBasico,89997680,89997675,-5,5,-1,115
2743,AgenteBasico,89997675,89997680,5,5,1,108
2744,AgenteBasico,89997680,89997685,5,5,1,102
2745,AgenteBasico,89997685,89997680,-5,5,-1,97
2746,AgenteBasico,89997680,89997680,0,5,0,91
2747,AgenteBasico,89997680,89997685,5,5,1,86
2748,AgenteBasico,89997685,89997690,5,5,1,75
2749,AgenteBasico,89997690,89997695,5,5,1,70
2750,AgenteBasico,89997695,89997702,7,5,1,62
2751,AgenteBasico,89997702,89997697,-5,5,-1,57
2752,AgenteBasico,89997697,89997692,-5,5,-1,52
2753,AgenteBasico,89997692,89997697,5,5,1,47
2754,AgenteBasico,89997697,89997702,5,5,1,42
2755,AgenteBasico,89997702,89997707,5,5,1,36
2756,AgenteBasico,89997707,89997697,-10,10,-1,31
2757,AgenteBasico,89997697,89997697,0,5,0,203
2758,AgenteBasico,89997697,89997694,-3,0,-1,198
2759,AgenteBasico,89997694,89997689,-5,5,-1,194
2760,AgenteBasico,89997689,89997684,-5,5,-1,188
2761,AgenteBasico,89997684,89997679,-5,5,-1,184
2762,AgenteBasico,89997679,89997669,-10,10,-1,177
2763,AgenteBasico,89997669,89997664,-5,5,-1,172
2764,AgenteBasico,89997664,89997674,10,10,1,166
2765,AgenteBasico,89997674,89997679,5,5,1,160
2766,AgenteBasico,89997679,89997676,-3,0,-1,152
2767,AgenteBasico,89997676,89997671,-5,5,-1,148
2768,AgenteBasico,89997671,89997676,5,5,1,144
2769,AgenteBasico,89997676,89997671,-5,5,-1,138
2770,AgenteBasico,89997671,89997666,-5,5,-1,134
2771,AgenteBasico,89997666,89997661,-5,5,-1,128
2772,AgenteBasico,89997661,89997656,-5,5,-1,123
2773,AgenteBasico,89997656,89997651,-5,5,-1,118
2774,AgenteBasico,89997651,89997641,-10,10,-1,111
2775,AgenteBasico,89997641,89997636,-5,5,-1,106
2776,AgenteBasico,89997636,89997636,0,5,0,101
2777,AgenteBasico,89997636,89997631,-5,5,-1,96
2778,AgenteBasico,89997631,89997636,5,5,1,91
2779,AgenteBasico,89997636,89997641,5,5,1,84
2780,AgenteBasico,89997641,89997636,-5,5,-1,79
2781,AgenteBasico,89997636,89997631,-5,5,-1,73
2782,AgenteBasico,89997631,89997626,-5,5,-1,68
2783,AgenteBasico,89997626,89997621,-5,5,-1,62
2784,AgenteBasico,89997621,89997626,5,5,1,57
2785,AgenteBasico,89997626,89997631,5,5,1,51
2786,AgenteBasico,89997631,89997621,-10,10,-1,45
2787,AgenteBasico,89997621,89997616,-5,5,-1,201
2788,AgenteBasico,89997616,89997611,-5,5,-1,194
2789,AgenteBasico,89997611,89997611,0,5,0,190
2790,AgenteBasico,89997611,89997606,-5,5,-1,184
2791,AgenteBasico,89997606,89997603,-3,0,-1,179
2792,AgenteBasico,89997603,89997603,0,5,0,174
2793,AgenteBasico,89997603,89997598,-5,5,-1,169
2794,AgenteBasico,89997598,89997593,-5,5,-1,164
2795,AgenteBasico,89997593,89997600,7,5,1,158
2796,AgenteBasico,89997600,89997610,10,10,1,154
2797,AgenteBasico,89997610,89997610,0,5,0,147
2798,AgenteBasico,89997610,89997615,5,5,1,140
2799,AgenteBasico,89997615,89997610,-5,5,-1,134
2800,AgenteBasico,89997610,89997605,-5,5,-1,127
2801,AgenteBasico,89997605,89997602,-3,0,-1,120
2802,AgenteBasico,89997602,89997602,0,5,0,116
2803,AgenteBasico,89997602,89997602,0,5,0,111
2804,AgenteBasico,89997602,89997597,-5,5,-1,104
2805,AgenteBasico,89997597,89997602,5,5,1,98
2806,AgenteBasico,89997602,89997599,-3,0,-1,92
2807,AgenteBasico,89997599,89997606,7,5,1,88
2808,AgenteBasico,89997606,89997616,10,10,1,82
2809,AgenteBasico,89997616,89997611,-5,5,-1,75
2810,AgenteBasico,89997611,89997606,-5,5,-1,70
2811,AgenteBasico,89997606,89997601,-5,5,-1,66
2812,AgenteBasico,89997601,89997591,-10,10,-1,62
2813,AgenteBasico,89997591,89997586,-5,5,-1,56
2814,AgenteBasico,89997586,89997581,-5,5,-1,52
2815,AgenteBasico,89997581,89997576,-5,5,-1,48
2816,AgenteBasico,89997576,89997581,5,5,1,42
2817,AgenteBasico,89997581,89997578,-3,0,-1,34
2818,AgenteBasico,89997578,89997575,-3,0,-1,204
2819,AgenteBasico,89997575,89997580,5,5,1,199
2820,AgenteBasico,89997580,89997575,-5,5,-1,193
2821,AgenteBasico,89997575,89997575,0,5,0,188
2822,AgenteBasico,89997575,89997570,-5,5,-1,182
2823,AgenteBasico,89997570,89997570,0,5,0,175
2824,AgenteBasico,89997570,89997570,0,5,0,168
2825,AgenteBasico,89997570,89997570,0,5,0,164
2826,AgenteBasico,89997570,89997577,7,5,1,158
2827,AgenteBasico,89997577,89997574,-3,0,-1,152
2828,AgenteBasico,89997574,89997571,-3,0,-1,148
2829,AgenteBasico,89997571,89997576,5,5,1,144
2830,AgenteBasico,89997576,89997571,-5,5,-1,137
2831,AgenteBasico,89997571,89997571,0,5,0,133
2832,AgenteBasico,89997571,89997571,0,10,0,128
2833,AgenteBasico,89997571,89997576,5,5,1,121
2834,AgenteBasico,89997576,89997576,0,5,0,116
2835,AgenteBasico,89997576,89997581,5,5,1,112
2836,AgenteBasico,89997581,89997581,0,5,0,105
2837,AgenteBasico,89997581,89997586,5,5,1,101
2838,AgenteBasico,89997586,89997581,-5,5,-1,95
2839,AgenteBasico,89997581,89997586,5,5,1,88
2840,AgenteBasico,89997586,89997591,5,5,1,83
2841,AgenteBasico,89997591,89997586,-5,5,-1,77
2842,AgenteBasico,89997586,89997591,5,5,1,70
2843,AgenteBasico,89997591,89997598,7,5,1,63
2844,AgenteBasico,89997598,89997593,-5,5,-1,59
2845,AgenteBasico,89997593,89997588,-5,5,-1,53
2846,AgenteBasico,89997588,89997583,-5,5,-1,49
2847,AgenteBasico,89997583,89997583,0,5,0,41
2848,AgenteBasico,89997583,89997583,0,5,0,204
2849,AgenteBasico,89997583,89997583,0,10,0,199
2850,AgenteBasico,89997583,89997583,0,5,0,193
2851,AgenteBasico,89997583,89997578,-5,5,-1,188
2852,AgenteBasico,89997578,89997575,-3,0,-1,182
2853,AgenteBasico,89997575,89997575,0,5,0,178
2854,AgenteBasico,89997575,89997575,0,5,0,173
2855,AgenteBasico,89997575,89997575,0,5,0,169
2856,AgenteBasico,89997575,89997575,0,5,0,164
2857,AgenteBasico,89997575,89997570,-5,5,-1,159
2858,AgenteBasico,89997570,89997565,-5,5,-1,154
2859,AgenteBasico,89997565,89997562,-3,0,-1,149
2860,AgenteBasico,89997562,89997557,-5,5,-1,145
2861,AgenteBasico,89997557,89997557,0,5,0,136
2862,AgenteBasico,89997557,89997557,0,5,0,129
2863,AgenteBasico,89997557,89997557,0,5,0,123
2864,AgenteBasico,89997557,89997557,0,5,0,118
2865,AgenteBasico,89997557,89997557,0,5,0,113
2866,AgenteBasico,89997557,89997552,-5,5,-1,108
2867,AgenteBasico,89997552,89997547,-5,5,-1,104
2868,AgenteBasico,89997547,89997542,-5,5,-1,99
2869,AgenteBasico,89997542,89997552,10,10,1,93
2870,AgenteBasico,89997552,89997557,5,5,1,87
2871,AgenteBasico,89997557,89997557,0,5,0,82
2872,AgenteBasico,89997557,89997552,-5,5,-1,77
2873,AgenteBasico,89997552,89997552,0,10,0,70
2874,AgenteBasico,89997552,89997552,0,5,0,63
2875,AgenteBasico,89997552,89997547,-5,5,-1,57
2876,AgenteBasico,89997547,89997542,-5,5,-1,49
2877,AgenteBasico,89997542,89997532,-10,10,-1,44
2878,AgenteBasico,89997532,89997532,0,5,0,37
2879,AgenteBasico,89997532,89997527,-5,5,-1,30
2880,AgenteBasico,89997527,89997534,7,5,1,203
2881,AgenteBasico,89997534,89997524,-10,10,-1,198
2882,AgenteBasico,89997524,89997529,5,5,1,192
2883,AgenteBasico,89997529,89997534,5,5,1,187
2884,AgenteBasico,89997534,89997529,-5,5,-1,182
2885,AgenteBasico,89997529,89997524,-5,5,-1,176
2886,AgenteBasico,89997524,89997519,-5,5,-1,170
2887,AgenteBasico,89997519,89997524,5,5,1,165
2888,AgenteBasico,89997524,89997529,5,5,1,158
2889,AgenteBasico,89997529,89997534,5,5,1,152
2890,AgenteBasico,89997534,89997529,-5,5,-1,146
2891,AgenteBasico,89997529,89997534,5,5,1,141
2892,AgenteBasico,89997534,89997524,-10,10,-1,135
2893,AgenteBasico,89997524,89997534,10,10,1,129
2894,AgenteBasico,89997534,89997529,-5,5,-1,122
2895,AgenteBasico,89997529,89997529,0,5,0,116
2896,AgenteBasico,89997529,89997529,0,5,0,112
2897,AgenteBasico,89997529,89997534,5,5,1,107
2898,AgenteBasico,89997534,89997529,-5,5,-1,102
2899,AgenteBasico,89997529,89997524,-5,5,-1,97
2900,AgenteBasico,89997524,89997519,-5,5,-1,91
2901,AgenteBasico,89997519,89997514,-5,5,-1,86
2902,AgenteBasico,89997514,89997509,-5,5,-1,79
2903,AgenteBasico,89997509,89997504,-5,10,-1,74
2904,AgenteBasico,89997504,89997501,-3,0,-1,65
2905,AgenteBasico,89997501,89997508,7,5,1,61
2906,AgenteBasico,89997508,89997513,5,5,1,57
2907,AgenteBasico,89997513,89997513,0,5,0,52
2908,AgenteBasico,89997513,89997510,-3,0,-1,45
2909,AgenteBasico,89997510,89997515,5,5,1,41
2910,AgenteBasico,89997515,89997510,-5,5,-1,35
2911,AgenteBasico,89997510,89997505,-5,5,-1,30
2912,AgenteBasico,89997505,89997500,-5,5,-1,204
2913,AgenteBasico,89997500,89997505,5,5,1,196
2914,AgenteBasico,89997505,89997502,-3,0,-1,186
2915,AgenteBasico,89997502,89997497,-5,5,-1,181
2916,AgenteBasico,89997497,89997497,0,5,0,177
2917,AgenteBasico,89997497,89997497,0,5,0,172
2918,AgenteBasico,89997497,89997502,5,5,1,168
2919,AgenteBasico,89997502,89997502,0,5,0,163
2920,AgenteBasico,89997502,89997497,-5,5,-1,158
2921,AgenteBasico,89997497,89997492,-5,5,-1,151
2922,AgenteBasico,89997492,89997489,-3,0,-1,146
2923,AgenteBasico,89997489,89997489,0,5,0,142
2924,AgenteBasico,89997489,89997479,-10,10,-1,136
2925,AgenteBasico,89997479,89997476,-3,0,-1,130
2926,AgenteBasico,89997476,89997466,-10,10,-1,124
2927,AgenteBasico,89997466,89997461,-5,5,-1,119
2928,AgenteBasico,89997461,89997461,0,5,0,115
2929,AgenteBasico,89997461,89997466,5,5,1,111
2930,AgenteBasico,89997466,89997461,-5,5,-1,104
2931,AgenteBasico,89997461,89997461,0,5,0,99
2932,AgenteBasico,89997461,89997456,-5,5,-1,94
2933,AgenteBasico,89997456,89997461,5,5,1,89
2934,AgenteBasico,89997461,89997456,-5,5,-1,83
2935,AgenteBasico,89997456,89997461,5,5,1,76
2936,AgenteBasico,89997461,89997461,0,5,0,71
2937,AgenteBasico,89997461,89997461,0,5,0,67
2938,AgenteBasico,89997461,89997456,-5,5,-1,62
2939,AgenteBasico,89997456,89997461,5,5,1,57
2940,AgenteBasico,89997461,89997456,-5,5,-1,51
2941,AgenteBasico,89997456,89997446,-10,10,-1,202
2942,AgenteBasico,89997446,89997443,-3,0,-1,197
2943,AgenteBasico,89997443,89997443,0,5,0,193
2944,AgenteBasico,89997443,89997438,-5,5,-1,188
2945,AgenteBasico,89997438,89997443,5,5,1,181
2946,AgenteBasico,89997443,89997438,-5,5,-1,175
2947,AgenteBasico,89997438,89997443,5,5,1,171
2948,AgenteBasico,89997443,89997443,0,5,0,165
2949,AgenteBasico,89997443,89997438,-5,5,-1,161
2950,AgenteBasico,89997438,89997428,-10,10,-1,156
2951,AgenteBasico,89997428,89997423,-5,5,-1,150
2952,AgenteBasico,89997423,89997433,10,10,1,142
2953,AgenteBasico,89997433,89997440,7,5,1,135
2954,AgenteBasico,89997440,89997435,-5,5,-1,131
2955,AgenteBasico,89997435,89997440,5,5,1,125
2956,AgenteBasico,89997440,89997435,-5,5,-1,119
2957,AgenteBasico,89997435,89997430,-5,5,-1,115
2958,AgenteBasico,89997430,89997415,-15,15,-1,110
2959,AgenteBasico,89997415,89997410,-5,5,-1,101
2960,AgenteBasico,89997410,89997405,-5,5,-1,96
2961,AgenteBasico,89997405,89997405,0,5,0,90
2962,AgenteBasico,89997405,89997410,5,5,1,84
2963,AgenteBasico,89997410,89997405,-5,5,-1,79
2964,AgenteBasico,89997405,89997400,-5,5,-1,74
2965,AgenteBasico,89997400,89997395,-5,5,-1,68
2966,AgenteBasico,89997395,89997400,5,5,1,64
2967,AgenteBasico,89997400,89997395,-5,5,-1,59
2968,AgenteBasico,89997395,89997395,0,5,0,54
2969,AgenteBasico,89997395,89997385,-10,10,-1,47
2970,AgenteBasico,89997385,89997382,-3,0,-1,202
2971,AgenteBasico,89997382,89997382,0,5,0,198
2972,AgenteBasico,89997382,89997377,-5,5,-1,194
2973,AgenteBasico,89997377,89997382,5,5,1,187
2974,AgenteBasico,89997382,89997382,0,5,0,182
2975,AgenteBasico,89997382,89997377,-5,5,-1,174
2976,AgenteBasico,89997377,89997374,-3,0,-1,169
2977,AgenteBasico,89997374,89997381,7,5,1,165
2978,AgenteBasico,89997381,89997376,-5,5,-1,161
2979,AgenteBasico,89997376,89997381,5,5,1,155
2980,AgenteBasico,89997381,89997381,0,5,0,149
2981,AgenteBasico,89997381,89997386,5,5,1,143
2982,AgenteBasico,89997386,89997381,-5,5,-1,138
2983,AgenteBasico,89997381,89997386,5,5,1,134
2984,AgenteBasico,89997386,89997386,0,5,0,129
2985,AgenteBasico,89997386,89997386,0,5,0,125
2986,AgenteBasico,89997386,89997401,15,15,1,120
2987,AgenteBasico,89997401,89997411,10,10,1,111
2988,AgenteBasico,89997411,89997411,0,5,0,104
2989,AgenteBasico,89997411,89997416,5,5,1,100
2990,AgenteBasico,89997416,89997421,5,5,1,94
2991,AgenteBasico,89997421,89997426,5,5,1,89
2992,AgenteBasico,89997426,89997421,-5,5,-1,83
2993,AgenteBasico,89997421,89997431,10,10,1,78
2994,AgenteBasico,89997431,89997436,5,5,1,71
2995,AgenteBasico,89997436,89997431,-5,5,-1,64
2996,AgenteBasico,89997431,89997426,-5,5,-1,57
2997,AgenteBasico,89997426,89997436,10,10,1,50
2998,AgenteBasico,89997436,89997431,-5,5,-1,43
2999,AgenteBasico,89997431,89997421,-10,10,-1,202
3000,AgenteBasico,89997421,89997418,-3,0,-1,197
3001,AgenteBasico,89997418,89997413,-5,5,-1,193
3002,AgenteBasico,89997413,89997413,0,5,0,188
3003,AgenteBasico,89997413,89997408,-5,5,-1,181
3004,AgenteBasico,89997408,89997408,0,5,0,175
3005,AgenteBasico,89997408,89997403,-5,5,-1,170
3006,AgenteBasico,89997403,89997408,5,5,1,163
3007,AgenteBasico,89997408,89997408,0,5,0,157
3008,AgenteBasico,89997408,89997408,0,5,0,153
3009,AgenteBasico,89997408,89997413,5,5,1,148
3010,AgenteBasico,89997413,89997408,-5,5,-1,142
3011,AgenteBasico,89997408,89997398,-10,10,-1,137
3012,AgenteBasico,89997398,89997393,-5,5,-1,131
3013,AgenteBasico,89997393,89997390,-3,0,-1,125
3014,AgenteBasico,89997390,89997387,-3,0,-1,121
3015,AgenteBasico,89997387,89997382,-5,5,-1,117
3016,AgenteBasico,89997382,89997382,0,5,0,111
3017,AgenteBasico,89997382,89997377,-5,5,-1,106
3018,AgenteBasico,89997377,89997372,-5,5,-1,100
3019,AgenteBasico,89997372,89997367,-5,5,-1,94
3020,AgenteBasico,89997367,89997367,0,10,0,88
3021,AgenteBasico,89997367,89997367,0,10,0,81
3022,AgenteBasico,89997367,89997372,5,5,1,75
3023,AgenteBasico,89997372,89997367,-5,5,-1,69
3024,AgenteBasico,89997367,89997372,5,5,1,63
3025,AgenteBasico,89997372,89997367,-5,5,-1,58
3026,AgenteBasico,89997367,89997367,0,5,0,52
3027,AgenteBasico,89997367,89997362,-5,5,-1,47
3028,AgenteBasico,89997362,89997362,0,5,0,41
3029,AgenteBasico,89997362,89997352,-10,10,-1,204
3030,AgenteBasico,89997352,89997347,-5,5,-1,198
3031,AgenteBasico,89997347,89997352,5,5,1,190
3032,AgenteBasico,89997352,89997352,0,5,0,184
3033,AgenteBasico,89997352,89997359,7,5,1,178
3034,AgenteBasico,89997359,89997359,0,5,0,174
3035,AgenteBasico,89997359,89997364,5,5,1,169
3036,AgenteBasico,89997364,89997359,-5,5,-1,163
3037,AgenteBasico,89997359,89997354,-5,5,-1,159
3038,AgenteBasico,89997354,89997354,0,5,0,154
3039,AgenteBasico,89997354,89997361,7,5,1,149
3040,AgenteBasico,89997361,89997356,-5,5,-1,145
3041,AgenteBasico,89997356,89997351,-5,5,-1,140
3042,AgenteBasico,89997351,89997361,10,10,1,133
3043,AgenteBasico,89997361,89997366,5,5,1,127
3044,AgenteBasico,89997366,89997356,-10,10,-1,122
3045,AgenteBasico,89997356,89997351,-5,5,-1,117
3046,AgenteBasico,89997351,89997346,-5,5,-1,112
3047,AgenteBasico,89997346,89997341,-5,5,-1,108
3048,AgenteBasico,89997341,89997336,-5,5,-1,103
3049,AgenteBasico,89997336,89997331,-5,5,-1,98
3050,AgenteBasico,89997331,89997336,5,5,1,93
3051,AgenteBasico,89997336,89997336,0,5,0,88
3052,AgenteBasico,89997336,89997331,-5,5,-1,84
3053,AgenteBasico,89997331,89997326,-5,5,-1,79
3054,AgenteBasico,89997326,89997326,0,5,0,74
3055,AgenteBasico,89997326,89997326,0,5,0,69
3056,AgenteBasico,89997326,89997321,-5,5,-1,64
3057,AgenteBasico,89997321,89997326,5,5,1,59
3058,AgenteBasico,89997326,89997326,0,5,0,51
3059,AgenteBasico,89997326,89997316,-10,10,-1,45
3060,AgenteBasico,89997316,89997326,10,10,1,199
3061,AgenteBasico,89997326,89997321,-5,5,-1,191
3062,AgenteBasico,89997321,89997321,0,10,0,184
3063,AgenteBasico,89997321,89997311,-10,10,-1,179
3064,AgenteBasico,89997311,89997311,0,5,0,173
3065,AgenteBasico,89997311,89997311,0,5,0,168
3066,AgenteBasico,89997311,89997311,0,5,0,163
3067,AgenteBasico,89997311,89997311,0,5,0,158
3068,AgenteBasico,89997311,89997316,5,5,1,154
3069,AgenteBasico,89997316,89997311,-5,5,-1,147
3070,AgenteBasico,89997311,89997306,-5,5,-1,142
3071,AgenteBasico,89997306,89997306,0,10,0,138
3072,AgenteBasico,89997306,89997303,-3,0,-1,132
3073,AgenteBasico,89997303,89997303,0,5,0,125
3074,AgenteBasico,89997303,89997298,-5,5,-1,118
3075,AgenteBasico,89997298,89997293,-5,5,-1,114
3076,AgenteBasico,89997293,89997298,5,5,1,109
3077,AgenteBasico,89997298,89997298,0,5,0,104
3078,AgenteBasico,89997298,89997295,-3,0,-1,99
3079,AgenteBasico,89997295,89997295,0,5,0,95
3080,AgenteBasico,89997295,89997300,5,5,1,91
3081,AgenteBasico,89997300,89997295,-5,5,-1,86
3082,AgenteBasico,89997295,89997295,0,5,0,81
3083,AgenteBasico,89997295,89997290,-5,5,-1,74
3084,AgenteBasico,89997290,89997290,0,5,0,69
3085,AgenteBasico,89997290,89997290,0,10,0,65
3086,AgenteBasico,89997290,89997285,-5,5,-1,60
3087,AgenteBasico,89997285,89997280,-5,5,-1,55
3088,AgenteBasico,89997280,89997280,0,5,0,49
3089,AgenteBasico,89997280,89997290,10,10,1,44
3090,AgenteBasico,89997290,89997285,-5,5,-1,36
3091,AgenteBasico,89997285,89997280,-5,5,-1,32
3092,AgenteBasico,89997280,89997275,-5,5,-1,203
3093,AgenteBasico,89997275,89997270,-5,5,-1,198
3094,AgenteBasico,89997270,89997265,-5,5,-1,192
3095,AgenteBasico,89997265,89997260,-5,5,-1,185
3096,AgenteBasico,89997260,89997255,-5,5,-1,179
3097,AgenteBasico,89997255,89997250,-5,5,-1,172
3098,AgenteBasico,89997250,89997255,5,5,1,168
3099,AgenteBasico,89997255,89997245,-10,10,-1,162
3100,AgenteBasico,89997245,89997240,-5,5,-1,157
3101,AgenteBasico,89997240,89997250,10,10,1,153
3102,AgenteBasico,89997250,89997257,7,5,1,146
3103,AgenteBasico,89997257,89997257,0,5,0,141
3104,AgenteBasico,89997257,89997257,0,5,0,136
3105,AgenteBasico,89997257,89997262,5,5,1,130
3106,AgenteBasico,89997262,89997267,5,5,1,124
3107,AgenteBasico,89997267,89997262,-5,5,-1,119
3108,AgenteBasico,89997262,89997267,5,5,1,114
3109,AgenteBasico,89997267,89997274,7,5,1,109
3110,AgenteBasico,89997274,89997271,-3,0,-1,104
3111,AgenteBasico,89997271,89997266,-5,5,-1,100
3112,AgenteBasico,89997266,89997276,10,10,1,94
3113,AgenteBasico,89997276,89997271,-5,5,-1,87
3114,AgenteBasico,89997271,89997266,-5,5,-1,82
3115,AgenteBasico,89997266,89997256,-10,10,-1,76
3116,AgenteBasico,89997256,89997256,0,5,0,70
3117,AgenteBasico,89997256,89997256,0,5,0,63
3118,AgenteBasico,89997256,89997256,0,5,0,59
3119,AgenteBasico,89997256,89997256,0,5,0,51
3120,AgenteBasico,89997256,89997251,-5,5,-1,47
3121,AgenteBasico,89997251,89997251,0,5,0,40
3122,AgenteBasico,89997251,89997256,5,5,1,36
3123,AgenteBasico,89997256,89997251,-5,5,-1,31
3124,AgenteBasico,89997251,89997251,0,5,0,202
3125,AgenteBasico,89997251,89997246,-5,5,-1,195
3126,AgenteBasico,89997246,89997251,5,5,1,189
3127,AgenteBasico,89997251,89997246,-5,5,-1,184
3128,AgenteBasico,89997246,89997251,5,5,1,177
3129,AgenteBasico,89997251,89997246,-5,5,-1,172
3130,AgenteBasico,89997246,89997251,5,5,1,167
3131,AgenteBasico,89997251,89997246,-5,5,-1,160
3132,AgenteBasico,89997246,89997253,7,5,1,154
3133,AgenteBasico,89997253,89997243,-10,10,-1,150
3134,AgenteBasico,89997243,89997250,7,5,1,145
3135,AgenteBasico,89997250,89997245,-5,5,-1,141
3136,AgenteBasico,89997245,89997245,0,5,0,136
3137,AgenteBasico,89997245,89997250,5,5,1,132
3138,AgenteBasico,89997250,89997255,5,5,1,126
3139,AgenteBasico,89997255,89997250,-5,5,-1,121
3140,AgenteBasico,89997250,89997250,0,5,0,116
3141,AgenteBasico,89997250,89997245,-5,5,-1,112
3142,AgenteBasico,89997245,89997252,7,5,1,107
3143,AgenteBasico,89997252,89997257,5,5,1,101
3144,AgenteBasico,89997257,89997257,0,5,0,94
3145,AgenteBasico,89997257,89997254,-3,0,-1,89
3146,AgenteBasico,89997254,89997254,0,5,0,85
3147,AgenteBasico,89997254,89997249,-5,5,-1,78
3148,AgenteBasico,89997249,89997246,-3,0,-1,74
3149,AgenteBasico,89997246,89997241,-5,5,-1,70
3150,AgenteBasico,89997241,89997241,0,5,0,63
3151,AgenteBasico,89997241,89997236,-5,5,-1,58
3152,AgenteBasico,89997236,89997231,-5,5,-1,52
3153,AgenteBasico,89997231,89997226,-5,5,-1,45
3154,AgenteBasico,89997226,89997231,5,5,1,200
3155,AgenteBasico,89997231,89997228,-3,0,-1,193
3156,AgenteBasico,89997228,89997223,-5,5,-1,188
3157,AgenteBasico,89997223,89997218,-5,5,-1,183
3158,AgenteBasico,89997218,89997218,0,5,0,175
3159,AgenteBasico,89997218,89997218,0,10,0,170
3160,AgenteBasico,89997218,89997223,5,5,1,162
3161,AgenteBasico,89997223,89997218,-5,5,-1,157
3162,AgenteBasico,89997218,89997218,0,5,0,152
3163,AgenteBasico,89997218,89997223,5,5,1,148
3164,AgenteBasico,89997223,89997223,0,5,0,143
3165,AgenteBasico,89997223,89997213,-10,10,-1,135
3166,AgenteBasico,89997213,89997208,-5,5,-1,128
3167,AgenteBasico,89997208,89997208,0,5,0,123
3168,AgenteBasico,89997208,89997203,-5,5,-1,118
3169,AgenteBasico,89997203,89997198,-5,5,-1,112
3170,AgenteBasico,89997198,89997198,0,5,0,107
3171,AgenteBasico,89997198,89997193,-5,5,-1,102
3172,AgenteBasico,89997193,89997193,0,10,0,97
3173,AgenteBasico,89997193,89997188,-5,5,-1,91
3174,AgenteBasico,89997188,89997183,-5,5,-1,85
3175,AgenteBasico,89997183,89997183,0,5,0,81
3176,AgenteBasico,89997183,89997183,0,5,0,75
3177,AgenteBasico,89997183,89997178,-5,5,-1,69
3178,AgenteBasico,89997178,89997173,-5,5,-1,64
3179,AgenteBasico,89997173,89997178,5,5,1,58
3180,AgenteBasico,89997178,89997185,7,5,1,52
3181,AgenteBasico,89997185,89997180,-5,5,-1,47
3182,AgenteBasico,89997180,89997180,0,5,0,203
3183,AgenteBasico,89997180,89997175,-5,5,-1,199
3184,AgenteBasico,89997175,89997175,0,5,0,192
3185,AgenteBasico,89997175,89997175,0,5,0,183
3186,AgenteBasico,89997175,89997172,-3,0,-1,179
3187,AgenteBasico,89997172,89997172,0,5,0,175
3188,AgenteBasico,89997172,89997167,-5,5,-1,170
3189,AgenteBasico,89997167,89997162,-5,5,-1,163
3190,AgenteBasico,89997162,89997162,0,5,0,156
3191,AgenteBasico,89997162,89997157,-5,5,-1,152
3192,AgenteBasico,89997157,89997164,7,5,1,145
3193,AgenteBasico,89997164,89997159,-5,5,-1,140
3194,AgenteBasico,89997159,89997164,5,5,1,135
3195,AgenteBasico,89997164,89997159,-5,5,-1,130
3196,AgenteBasico,89997159,89997154,-5,5,-1,125
3197,AgenteBasico,89997154,89997149,-5,5,-1,118
3198,AgenteBasico,89997149,89997149,0,5,0,114
3199,AgenteBasico,89997149,89997144,-5,5,-1,110
3200,AgenteBasico,89997144,89997151,7,5,1,103
3201,AgenteBasico,89997151,89997141,-10,10,-1,99
3202,AgenteBasico,89997141,89997141,0,5,0,94
3203,AgenteBasico,89997141,89997146,5,5,1,89
3204,AgenteBasico,89997146,89997146,0,10,0,82
3205,AgenteBasico,89997146,89997141,-5,5,-1,77
3206,AgenteBasico,89997141,89997151,10,10,1,72
3207,AgenteBasico,89997151,89997151,0,5,0,65
3208,AgenteBasico,89997151,89997146,-5,5,-1,61
3209,AgenteBasico,89997146,89997151,5,5,1,56
3210,AgenteBasico,89997151,89997151,0,5,0,51
3211,AgenteBasico,89997151,89997146,-5,5,-1,45
3212,AgenteBasico,89997146,89997141,-5,5,-1,40
3213,AgenteBasico,89997141,89997136,-5,5,-1,203
3214,AgenteBasico,89997136,89997143,7,5,1,198
3215,AgenteBasico,89997143,89997148,5,5,1,191
3216,AgenteBasico,89997148,89997143,-5,5,-1,185
3217,AgenteBasico,89997143,89997138,-5,5,-1,181
3218,AgenteBasico,89997138,89997133,-5,5,-1,175
3219,AgenteBasico,89997133,89997133,0,5,0,167
3220,AgenteBasico,89997133,89997133,0,5,0,162
3221,AgenteBasico,89997133,89997128,-5,5,-1,157
3222,AgenteBasico,89997128,89997123,-5,5,-1,152
3223,AgenteBasico,89997123,89997113,-10,10,-1,145
3224,AgenteBasico,89997113,89997108,-5,5,-1,140
3225,AgenteBasico,89997108,89997098,-10,10,-1,135
3226,AgenteBasico,89997098,89997093,-5,5,-1,129
3227,AgenteBasico,89997093,89997100,7,5,1,124
3228,AgenteBasico,89997100,89997095,-5,5,-1,120
3229,AgenteBasico,89997095,89997085,-10,10,-1,114
3230,AgenteBasico,89997085,89997080,-5,5,-1,108
3231,AgenteBasico,89997080,89997085,5,5,1,103
3232,AgenteBasico,89997085,89997080,-5,5,-1,97
3233,AgenteBasico,89997080,89997080,0,5,0,91
3234,AgenteBasico,89997080,89997085,5,5,1,86
3235,AgenteBasico,89997085,89997080,-5,5,-1,80
3236,AgenteBasico,89997080,89997080,0,10,0,74
3237,AgenteBasico,89997080,89997075,-5,5,-1,69
3238,AgenteBasico,89997075,89997075,0,5,0,65
3239,AgenteBasico,89997075,89997082,7,5,1,60
3240,AgenteBasico,89997082,89997079,-3,0,-1,56
3241,AgenteBasico,89997079,89997079,0,5,0,52
3242,AgenteBasico,89997079,89997086,7,5,1,47
3243,AgenteBasico,89997086,89997091,5,5,1,41
3244,AgenteBasico,89997091,89997096,5,5,1,202
3245,AgenteBasico,89997096,89997093,-3,0,-1,197
3246,AgenteBasico,89997093,89997088,-5,5,-1,191
3247,AgenteBasico,89997088,89997085,-3,0,-1,184
3248,AgenteBasico,89997085,89997080,-5,5,-1,179
3249,AgenteBasico,89997080,89997075,-5,5,-1,172
3250,AgenteBasico,89997075,89997080,5,5,1,167
3251,AgenteBasico,89997080,89997085,5,5,1,161
3252,AgenteBasico,89997085,89997085,0,10,0,154
3253,AgenteBasico,89997085,89997080,-5,5,-1,148
3254,AgenteBasico,89997080,89997087,7,5,1,142
3255,AgenteBasico,89997087,89997082,-5,5,-1,137
3256,AgenteBasico,89997082,89997082,0,5,0,132
3257,AgenteBasico,89997082,89997077,-5,5,-1,127
3258,AgenteBasico,89997077,89997082,5,5,1,120
3259,AgenteBasico,89997082,89997079,-3,0,-1,113
3260,AgenteBasico,89997079,89997074,-5,5,-1,109
3261,AgenteBasico,89997074,89997074,0,5,0,103
3262,AgenteBasico,89997074,89997069,-5,5,-1,97
3263,AgenteBasico,89997069,89997074,5,5,1,92
3264,AgenteBasico,89997074,89997069,-5,5,-1,85
3265,AgenteBasico,89997069,89997076,7,5,1,80
3266,AgenteBasico,89997076,89997081,5,5,1,76
3267,AgenteBasico,89997081,89997071,-10,10,-1,70
3268,AgenteBasico,89997071,89997071,0,5,0,65
3269,AgenteBasico,89997071,89997071,0,5,0,60
3270,AgenteBasico,89997071,89997066,-5,5,-1,55
3271,AgenteBasico,89997066,89997061,-5,5,-1,50
3272,AgenteBasico,89997061,89997061,0,5,0,45
3273,AgenteBasico,89997061,89997061,0,5,0,38
3274,AgenteBasico,89997061,89997061,0,10,0,203
3275,AgenteBasico,89997061,89997056,-5,5,-1,193
3276,AgenteBasico,89997056,89997056,0,5,0,188
3277,AgenteBasico,89997056,89997056,0,5,0,182
3278,AgenteBasico,89997056,89997063,7,5,1,178
3279,AgenteBasico,89997063,89997058,-5,5,-1,174
3280,AgenteBasico,89997058,89997053,-5,5,-1,168
3281,AgenteBasico,89997053,89997048,-5,5,-1,162
3282,AgenteBasico,89997048,89997053,5,5,1,156
3283,AgenteBasico,89997053,89997048,-5,5,-1,151
3284,AgenteBasico,89997048,89997055,7,5,1,144
3285,AgenteBasico,89997055,89997050,-5,5,-1,139
3286,AgenteBasico,89997050,89997050,0,5,0,134
3287,AgenteBasico,89997050,89997045,-5,5,-1,130
3288,AgenteBasico,89997045,89997040,-5,5,-1,125
3289,AgenteBasico,89997040,89997040,0,5,0,120
3290,AgenteBasico,89997040,89997040,0,5,0,115
3291,AgenteBasico,89997040,89997035,-5,5,-1,109
3292,AgenteBasico,89997035,89997032,-3,0,-1,103
3293,AgenteBasico,89997032,89997032,0,5,0,99
3294,AgenteBasico,89997032,89997039,7,5,1,93
3295,AgenteBasico,89997039,89997039,0,5,0,88
3296,AgenteBasico,89997039,89997034,-5,5,-1,81
3297,AgenteBasico,89997034,89997039,5,5,1,77
3298,AgenteBasico,89997039,89997034,-5,5,-1,71
3299,AgenteBasico,89997034,89997034,0,5,0,65
3300,AgenteBasico,89997034,89997031,-3,0,-1,61
3301,AgenteBasico,89997031,89997026,-5,5,-1,56
3302,AgenteBasico,89997026,89997026,0,5,0,50
3303,AgenteBasico,89997026,89997021,-5,5,-1,46
3304,AgenteBasico,89997021,89997011,-10,10,-1,39
3305,AgenteBasico,89997011,89997008,-3,0,-1,32
3306,AgenteBasico,89997008,89997005,-3,0,-1,203
3307,AgenteBasico,89997005,89997000,-5,5,-1,198
3308,AgenteBasico,89997000,89997000,0,5,0,193
3309,AgenteBasico,89997000,89997000,0,5,0,188
3310,AgenteBasico,89997000,89997000,0,5,0,183
3311,AgenteBasico,89997000,89996995,-5,5,-1,178
3312,AgenteBasico,89996995,89996995,0,5,0,173
3313,AgenteBasico,89996995,89997000,5,5,1,169
3314,AgenteBasico,89997000,89997007,7,5,1,164
3315,AgenteBasico,89997007,89997002,-5,5,-1,160
3316,AgenteBasico,89997002,89996997,-5,5,-1,154
3317,AgenteBasico,89996997,89996992,-5,5,-1,149
3318,AgenteBasico,89996992,89996987,-5,5,-1,144
3319,AgenteBasico,89996987,89996982,-5,5,-1,138
3320,AgenteBasico,89996982,89996982,0,5,0,133
3321,AgenteBasico,89996982,89996987,5,5,1,127
3322,AgenteBasico,89996987,89996982,-5,5,-1,121
3323,AgenteBasico,89996982,89996982,0,5,0,115
3324,AgenteBasico,89996982,89996982,0,5,0,110
3325,AgenteBasico,89996982,89996977,-5,5,-1,105
3326,AgenteBasico,89996977,89996977,0,10,0,100
3327,AgenteBasico,89996977,89996977,0,5,0,94
3328,AgenteBasico,89996977,89996967,-10,10,-1,89
3329,AgenteBasico,89996967,89996962,-5,5,-1,83
3330,AgenteBasico,89996962,89996962,0,5,0,77
3331,AgenteBasico,89996962,89996959,-3,0,-1,72
3332,AgenteBasico,89996959,89996959,0,5,0,68
3333,AgenteBasico,89996959,89996956,-3,0,-1,63
3334,AgenteBasico,89996956,89996961,5,5,1,59
3335,AgenteBasico,89996961,89996956,-5,5,-1,53
3336,AgenteBasico,89996956,89996951,-5,5,-1,47
3337,AgenteBasico,89996951,89996946,-5,5,-1,203
3338,AgenteBasico,89996946,89996946,0,5,0,196
3339,AgenteBasico,89996946,89996936,-10,10,-1,190
3340,AgenteBasico,89996936,89996931,-5,5,-1,184
3341,AgenteBasico,89996931,89996936,5,5,1,176
3342,AgenteBasico,89996936,89996931,-5,5,-1,170
3343,AgenteBasico,89996931,89996936,5,5,1,166
3344,AgenteBasico,89996936,89996931,-5,5,-1,161
3345,AgenteBasico,89996931,89996926,-5,5,-1,156
3346,AgenteBasico,89996926,89996921,-5,5,-1,151
3347,AgenteBasico,89996921,89996921,0,5,0,146
3348,AgenteBasico,89996921,89996921,0,5,0,140
3349,AgenteBasico,89996921,89996916,-5,5,-1,135
3350,AgenteBasico,89996916,89996916,0,5,0,129
3351,AgenteBasico,89996916,89996916,0,5,0,122
3352,AgenteBasico,89996916,89996911,-5,5,-1,117
3353,AgenteBasico,89996911,89996916,5,5,1,110
3354,AgenteBasico,89996916,89996921,5,5,1,104
3355,AgenteBasico,89996921,89996916,-5,5,-1,97
3356,AgenteBasico,89996916,89996913,-3,0,-1,90
3357,AgenteBasico,89996913,89996910,-3,0,-1,86
3358,AgenteBasico,89996910,89996910,0,5,0,82
3359,AgenteBasico,89996910,89996920,10,10,1,77
3360,AgenteBasico,89996920,89996910,-10,10,-1,71
3361,AgenteBasico,89996910,89996910,0,10,0,65
3362,AgenteBasico,89996910,89996905,-5,5,-1,60
3363,AgenteBasico,89996905,89996905,0,10,0,55
3364,AgenteBasico,89996905,89996905,0,5,0,49
3365,AgenteBasico,89996905,89996905,0,5,0,203
3366,AgenteBasico,89996905,89996900,-5,5,-1,197
3367,AgenteBasico,89996900,89996900,0,10,0,192
3368,AgenteBasico,89996900,89996905,5,5,1,186
3369,AgenteBasico,89996905,89996910,5,5,1,180
3370,AgenteBasico,89996910,89996915,5,5,1,174
3371,AgenteBasico,89996915,89996910,-5,5,-1,168
3372,AgenteBasico,89996910,89996910,0,5,0,163
3373,AgenteBasico,89996910,89996907,-3,0,-1,157
3374,AgenteBasico,89996907,89996907,0,5,0,153
3375,AgenteBasico,89996907,89996907,0,10,0,147
3376,AgenteBasico,89996907,89996912,5,5,1,141
3377,AgenteBasico,89996912,89996912,0,5,0,135
3378,AgenteBasico,89996912,89996902,-10,10,-1,130
3379,AgenteBasico,89996902,89996892,-10,10,-1,123
3380,AgenteBasico,89996892,89996897,5,5,1,118
3381,AgenteBasico,89996897,89996892,-5,5,-1,110
3382,AgenteBasico,89996892,89996887,-5,5,-1,105
3383,AgenteBasico,89996887,89996877,-10,10,-1,98
3384,AgenteBasico,89996877,89996882,5,5,1,91
3385,AgenteBasico,89996882,89996879,-3,0,-1,85
3386,AgenteBasico,89996879,89996884,5,5,1,81
3387,AgenteBasico,89996884,89996884,0,5,0,73
3388,AgenteBasico,89996884,89996889,5,5,1,67
3389,AgenteBasico,89996889,89996894,5,5,1,62
3390,AgenteBasico,89996894,89996889,-5,5,-1,56
3391,AgenteBasico,89996889,89996889,0,5,0,52
3392,AgenteBasico,89996889,89996886,-3,0,-1,45
3393,AgenteBasico,89996886,89996883,-3,0,-1,40
3394,AgenteBasico,89996883,89996883,0,5,0,203
3395,AgenteBasico,89996883,89996888,5,5,1,199
3396,AgenteBasico,89996888,89996885,-3,0,-1,193
3397,AgenteBasico,89996885,89996875,-10,10,-1,189
3398,AgenteBasico,89996875,89996875,0,5,0,180
3399,AgenteBasico,89996875,89996870,-5,5,-1,175
3400,AgenteBasico,89996870,89996870,0,5,0,168
3401,AgenteBasico,89996870,89996870,0,5,0,163
3402,AgenteBasico,89996870,89996875,5,5,1,156
3403,AgenteBasico,89996875,89996872,-3,0,-1,151
3404,AgenteBasico,89996872,89996877,5,5,1,147
3405,AgenteBasico,89996877,89996872,-5,5,-1,142
3406,AgenteBasico,89996872,89996872,0,5,0,134
3407,AgenteBasico,89996872,89996867,-5,5,-1,128
3408,AgenteBasico,89996867,89996867,0,10,0,122
3409,AgenteBasico,89996867,89996867,0,5,0,116
3410,AgenteBasico,89996867,89996867,0,5,0,110
3411,AgenteBasico,89996867,89996872,5,5,1,106
3412,AgenteBasico,89996872,89996867,-5,5,-1,101
3413,AgenteBasico,89996867,89996872,5,5,1,95
3414,AgenteBasico,89996872,89996872,0,10,0,90
3415,AgenteBasico,89996872,89996872,0,5,0,84
3416,AgenteBasico,89996872,89996872,0,5,0,78
3417,AgenteBasico,89996872,89996879,7,5,1,74
3418,AgenteBasico,89996879,89996874,-5,5,-1,68
3419,AgenteBasico,89996874,89996869,-5,5,-1,61
3420,AgenteBasico,89996869,89996874,5,5,1,56
3421,AgenteBasico,89996874,89996874,0,10,0,49
3422,AgenteBasico,89996874,89996879,5,5,1,42
3423,AgenteBasico,89996879,89996874,-5,5,-1,203
3424,AgenteBasico,89996874,89996874,0,10,0,198
3425,AgenteBasico,89996874,89996879,5,5,1,193
3426,AgenteBasico,89996879,89996874,-5,5,-1,187
3427,AgenteBasico,89996874,89996869,-5,5,-1,182
3428,AgenteBasico,89996869,89996874,5,5,1,176
3429,AgenteBasico,89996874,89996879,5,5,1,171
3430,AgenteBasico,89996879,89996879,0,5,0,163
3431,AgenteBasico,89996879,89996879,0,5,0,156
3432,AgenteBasico,89996879,89996869,-10,10,-1,152
3433,AgenteBasico,89996869,89996864,-5,5,-1,146
3434,AgenteBasico,89996864,89996859,-5,5,-1,141
3435,AgenteBasico,89996859,89996854,-5,5,-1,135
3436,AgenteBasico,89996854,89996849,-5,5,-1,130
3437,AgenteBasico,89996849,89996856,7,5,1,125
3438,AgenteBasico,89996856,89996853,-3,0,-1,120
3439,AgenteBasico,89996853,89996860,7,5,1,116
3440,AgenteBasico,89996860,89996855,-5,5,-1,111
3441,AgenteBasico,89996855,89996855,0,5,0,106
3442,AgenteBasico,89996855,89996850,-5,5,-1,100
3443,AgenteBasico,89996850,89996850,0,5,0,93
3444,AgenteBasico,89996850,89996850,0,5,0,89
3445,AgenteBasico,89996850,89996850,0,5,0,84
3446,AgenteBasico,89996850,89996847,-3,0,-1,78
3447,AgenteBasico,89996847,89996852,5,5,1,73
3448,AgenteBasico,89996852,89996842,-10,10,-1,68
3449,AgenteBasico,89996842,89996837,-5,5,-1,61
3450,AgenteBasico,89996837,89996842,5,5,1,55
3451,AgenteBasico,89996842,89996847,5,5,1,50
3452,AgenteBasico,89996847,89996842,-5,5,-1,43
3453,AgenteBasico,89996842,89996849,7,5,1,203
3454,AgenteBasico,89996849,89996854,5,5,1,198
3455,AgenteBasico,89996854,89996849,-5,5,-1,192
3456,AgenteBasico,89996849,89996856,7,5,1,186
3457,AgenteBasico,89996856,89996861,5,5,1,182
3458,AgenteBasico,89996861,89996856,-5,5,-1,177
3459,AgenteBasico,89996856,89996866,10,10,1,171
3460,AgenteBasico,89996866,89996866,0,5,0,165
3461,AgenteBasico,89996866,89996871,5,5,1,159
3462,AgenteBasico,89996871,89996866,-5,5,-1,153
3463,AgenteBasico,89996866,89996866,0,5,0,147
3464,AgenteBasico,89996866,89996861,-5,5,-1,141
3465,AgenteBasico,89996861,89996866,5,5,1,136
3466,AgenteBasico,89996866,89996871,5,5,1,129
3467,AgenteBasico,89996871,89996866,-5,5,-1,124
3468,AgenteBasico,89996866,89996861,-5,5,-1,117
3469,AgenteBasico,89996861,89996856,-5,5,-1,113
3470,AgenteBasico,89996856,89996851,-5,5,-1,107
3471,AgenteBasico,89996851,89996861,10,10,1,101
3472,AgenteBasico,89996861,89996856,-5,5,-1,94
3473,AgenteBasico,89996856,89996851,-5,5,-1,87
3474,AgenteBasico,89996851,89996851,0,5,0,80
3475,AgenteBasico,89996851,89996851,0,5,0,74
3476,AgenteBasico,89996851,89996846,-5,5,-1,70
3477,AgenteBasico,89996846,89996841,-5,5,-1,65
3478,AgenteBasico,89996841,89996836,-5,5,-1,60
3479,AgenteBasico,89996836,89996841,5,5,1,55
3480,AgenteBasico,89996841,89996841,0,10,0,50
3481,AgenteBasico,89996841,89996831,-10,10,-1,44
3482,AgenteBasico,89996831,89996831,0,10,0,38
3483,AgenteBasico,89996831,89996841,10,10,1,203
3484,AgenteBasico,89996841,89996836,-5,5,-1,197
3485,AgenteBasico,89996836,89996831,-5,5,-1,192
3486,AgenteBasico,89996831,89996826,-5,5,-1,187
3487,AgenteBasico,89996826,89996833,7,5,1,182
3488,AgenteBasico,89996833,89996828,-5,5,-1,178
3489,AgenteBasico,89996828,89996818,-10,10,-1,173
3490,AgenteBasico,89996818,89996815,-3,0,-1,168
3491,AgenteBasico,89996815,89996820,5,5,1,164
3492,AgenteBasico,89996820,89996820,0,5,0,158
3493,AgenteBasico,89996820,89996830,10,10,1,153
3494,AgenteBasico,89996830,89996825,-5,5,-1,147
3495,AgenteBasico,89996825,89996832,7,5,1,140
3496,AgenteBasico,89996832,89996827,-5,5,-1,135
3497,AgenteBasico,89996827,89996834,7,5,1,129
3498,AgenteBasico,89996834,89996829,-5,5,-1,122
3499,AgenteBasico,89996829,89996829,0,5,0,116
3500,AgenteBasico,89996829,89996819,-10,10,-1,109
3501,AgenteBasico,89996819,89996814,-5,5,-1,104
3502,AgenteBasico,89996814,89996809,-5,5,-1,98
3503,AgenteBasico,89996809,89996816,7,5,1,93
3504,AgenteBasico,89996816,89996821,5,5,1,88
3505,AgenteBasico,89996821,89996816,-5,5,-1,83
3506,AgenteBasico,89996816,89996816,0,5,0,77
3507,AgenteBasico,89996816,89996816,0,5,0,70
3508,AgenteBasico,89996816,89996821,5,5,1,66
3509,AgenteBasico,89996821,89996816,-5,5,-1,60
3510,AgenteBasico,89996816,89996821,5,5,1,54
3511,AgenteBasico,89996821,89996821,0,5,0,48
3512,AgenteBasico,89996821,89996831,10,10,1,43
3513,AgenteBasico,89996831,89996831,0,5,0,37
3514,AgenteBasico,89996831,89996826,-5,5,-1,203
3515,AgenteBasico,89996826,89996831,5,5,1,195
3516,AgenteBasico,89996831,89996826,-5,5,-1,188
3517,AgenteBasico,89996826,89996821,-5,5,-1,181
3518,AgenteBasico,89996821,89996816,-5,5,-1,177
3519,AgenteBasico,89996816,89996823,7,5,1,172
3520,AgenteBasico,89996823,89996818,-5,5,-1,168
3521,AgenteBasico,89996818,89996823,5,5,1,164
3522,AgenteBasico,89996823,89996818,-5,5,-1,157
3523,AgenteBasico,89996818,89996823,5,5,1,151
3524,AgenteBasico,89996823,89996828,5,5,1,146
3525,AgenteBasico,89996828,89996818,-10,10,-1,140
3526,AgenteBasico,89996818,89996813,-5,5,-1,135
3527,AgenteBasico,89996813,89996808,-5,5,-1,130
3528,AgenteBasico,89996808,89996803,-5,5,-1,125
3529,AgenteBasico,89996803,89996810,7,5,1,120
3530,AgenteBasico,89996810,89996805,-5,5,-1,115
3531,AgenteBasico,89996805,89996805,0,5,0,110
3532,AgenteBasico,89996805,89996800,-5,5,-1,105
3533,AgenteBasico,89996800,89996795,-5,5,-1,100
3534,AgenteBasico,89996795,89996795,0,5,0,95
3535,AgenteBasico,89996795,89996790,-5,5,-1,89
3536,AgenteBasico,89996790,89996795,5,5,1,83
3537,AgenteBasico,89996795,89996800,5,5,1,77
3538,AgenteBasico,89996800,89996810,10,10,1,72
3539,AgenteBasico,89996810,89996810,0,5,0,66
3540,AgenteBasico,89996810,89996810,0,5,0,61
3541,AgenteBasico,89996810,89996810,0,5,0,56
3542,AgenteBasico,89996810,89996810,0,5,0,50
3543,AgenteBasico,89996810,89996805,-5,5,-1,45
3544,AgenteBasico,89996805,89996800,-5,5,-1,202
3545,AgenteBasico,89996800,89996795,-5,5,-1,196
3546,AgenteBasico,89996795,89996800,5,5,1,191
3547,AgenteBasico,89996800,89996795,-5,5,-1,185
3548,AgenteBasico,89996795,89996792,-3,0,-1,179
3549,AgenteBasico,89996792,89996792,0,5,0,173
3550,AgenteBasico,89996792,89996782,-10,10,-1,169
3551,AgenteBasico,89996782,89996779,-3,0,-1,162
3552,AgenteBasico,89996779,89996774,-5,5,-1,157
3553,AgenteBasico,89996774,89996769,-5,5,-1,152
3554,AgenteBasico,89996769,89996774,5,5,1,147
3555,AgenteBasico,89996774,89996781,7,5,1,142
3556,AgenteBasico,89996781,89996776,-5,5,-1,137
3557,AgenteBasico,89996776,89996781,5,5,1,131
3558,AgenteBasico,89996781,89996786,5,5,1,125
3559,AgenteBasico,89996786,89996786,0,5,0,118
3560,AgenteBasico,89996786,89996781,-5,5,-1,112
3561,AgenteBasico,89996781,89996776,-5,5,-1,106
3562,AgenteBasico,89996776,89996776,0,5,0,100
3563,AgenteBasico,89996776,89996771,-5,5,-1,95
3564,AgenteBasico,89996771,89996771,0,10,0,89
3565,AgenteBasico,89996771,89996766,-5,5,-1,84
3566,AgenteBasico,89996766,89996761,-5,5,-1,78
3567,AgenteBasico,89996761,89996766,5,5,1,71
3568,AgenteBasico,89996766,89996771,5,5,1,65
3569,AgenteBasico,89996771,89996776,5,5,1,60
3570,AgenteBasico,89996776,89996776,0,5,0,55
3571,AgenteBasico,89996776,89996771,-5,5,-1,50
3572,AgenteBasico,89996771,89996766,-5,5,-1,44
3573,AgenteBasico,89996766,89996766,0,5,0,39
3574,AgenteBasico,89996766,89996761,-5,5,-1,34
3575,AgenteBasico,89996761,89996756,-5,5,-1,27
3576,AgenteBasico,89996756,89996751,-5,5,-1,202
3577,AgenteBasico,89996751,89996746,-5,5,-1,195
3578,AgenteBasico,89996746,89996741,-5,5,-1,190
3579,AgenteBasico,89996741,89996751,10,10,1,185
3580,AgenteBasico,89996751,89996746,-5,5,-1,179
3581,AgenteBasico,89996746,89996751,5,5,1,172
3582,AgenteBasico,89996751,89996751,0,10,0,166
3583,AgenteBasico,89996751,89996756,5,5,1,161
3584,AgenteBasico,89996756,89996751,-5,5,-1,156
3585,AgenteBasico,89996751,89996751,0,10,0,150
3586,AgenteBasico,89996751,89996751,0,5,0,142
3587,AgenteBasico,89996751,89996746,-5,5,-1,137
3588,AgenteBasico,89996746,89996746,0,5,0,131
3589,AgenteBasico,89996746,89996751,5,5,1,125
3590,AgenteBasico,89996751,89996756,5,5,1,119
3591,AgenteBasico,89996756,89996751,-5,5,-1,113
3592,AgenteBasico,89996751,89996756,5,5,1,108
3593,AgenteBasico,89996756,89996751,-5,5,-1,103
3594,AgenteBasico,89996751,89996751,0,5,0,97
3595,AgenteBasico,89996751,89996746,-5,5,-1,92
3596,AgenteBasico,89996746,89996741,-5,5,-1,85
3597,AgenteBasico,89996741,89996736,-5,5,-1,80
3598,AgenteBasico,89996736,89996746,10,10,1,74
3599,AgenteBasico,89996746,89996743,-3,0,-1,67
3600,AgenteBasico,89996743,89996738,-5,5,-1,63
3601,AgenteBasico,89996738,89996738,0,5,0,57
3602,AgenteBasico,89996738,89996738,0,10,0,51
3603,AgenteBasico,89996738,89996733,-5,5,-1,45
3604,AgenteBasico,89996733,89996733,0,5,0,201
3605,AgenteBasico,89996733,89996728,-5,5,-1,195
3606,AgenteBasico,89996728,89996733,5,5,1,190
3607,AgenteBasico,89996733,89996728,-5,5,-1,184
3608,AgenteBasico,89996728,89996728,0,5,0,179
3609,AgenteBasico,89996728,89996733,5,5,1,175
3610,AgenteBasico,89996733,89996728,-5,5,-1,169
3611,AgenteBasico,89996728,89996723,-5,5,-1,163
3612,AgenteBasico,89996723,89996720,-3,0,-1,159
3613,AgenteBasico,89996720,89996727,7,5,1,155
3614,AgenteBasico,89996727,89996722,-5,5,-1,150
3615,AgenteBasico,89996722,89996722,0,5,0,145
3616,AgenteBasico,89996722,89996727,5,5,1,138
3617,AgenteBasico,89996727,89996737,10,10,1,133
3618,AgenteBasico,89996737,89996742,5,5,1,127
3619,AgenteBasico,89996742,89996749,7,5,1,119
3620,AgenteBasico,89996749,89996749,0,5,0,114
3621,AgenteBasico,89996749,89996744,-5,5,-1,108
3622,AgenteBasico,89996744,89996749,5,5,1,103
3623,AgenteBasico,89996749,89996754,5,5,1,97
3624,AgenteBasico,89996754,89996754,0,5,0,91
3625,AgenteBasico,89996754,89996749,-5,5,-1,86
3626,AgenteBasico,89996749,89996739,-10,10,-1,80
3627,AgenteBasico,89996739,89996739,0,5,0,74
3628,AgenteBasico,89996739,89996744,5,5,1,70
3629,AgenteBasico,89996744,89996739,-5,5,-1,63
3630,AgenteBasico,89996739,89996734,-5,5,-1,58
3631,AgenteBasico,89996734,89996731,-3,0,-1,53
3632,AgenteBasico,89996731,89996726,-5,5,-1,49
3633,AgenteBasico,89996726,89996721,-5,5,-1,44
3634,AgenteBasico,89996721,89996716,-5,5,-1,39
3635,AgenteBasico,89996716,89996716,0,5,0,204
3636,AgenteBasico,89996716,89996723,7,5,1,199
3637,AgenteBasico,89996723,89996730,7,5,1,195
3638,AgenteBasico,89996730,89996735,5,5,1,190
3639,AgenteBasico,89996735,89996735,0,10,0,183
3640,AgenteBasico,89996735,89996732,-3,0,-1,176
3641,AgenteBasico,89996732,89996727,-5,5,-1,171
3642,AgenteBasico,89996727,89996727,0,5,0,166
3643,AgenteBasico,89996727,89996722,-5,5,-1,161
3644,AgenteBasico,89996722,89996717,-5,5,-1,153
3645,AgenteBasico,89996717,89996712,-5,5,-1,148
3646,AgenteBasico,89996712,89996712,0,10,0,142
3647,AgenteBasico,89996712,89996717,5,5,1,136
3648,AgenteBasico,89996717,89996712,-5,5,-1,130
3649,AgenteBasico,89996712,89996717,5,5,1,126
3650,AgenteBasico,89996717,89996717,0,5,0,119
3651,AgenteBasico,89996717,89996712,-5,5,-1,113
3652,AgenteBasico,89996712,89996712,0,5,0,108
3653,AgenteBasico,89996712,89996707,-5,5,-1,103
3654,AgenteBasico,89996707,89996702,-5,5,-1,98
3655,AgenteBasico,89996702,89996702,0,5,0,91
3656,AgenteBasico,89996702,89996707,5,5,1,86
3657,AgenteBasico,89996707,89996727,20,20,1,78
3658,AgenteBasico,89996727,89996732,5,5,1,69
3659,AgenteBasico,89996732,89996727,-5,5,-1,64
3660,AgenteBasico,89996727,89996727,0,5,0,59
3661,AgenteBasico,89996727,89996722,-5,5,-1,55
3662,AgenteBasico,89996722,89996722,0,5,0,50
3663,AgenteBasico,89996722,89996717,-5,5,-1,44
3664,AgenteBasico,89996717,89996717,0,5,0,39
3665,AgenteBasico,89996717,89996722,5,5,1,34
3666,AgenteBasico,89996722,89996717,-5,5,-1,28
3667,AgenteBasico,89996717,89996712,-5,5,-1,203
3668,AgenteBasico,89996712,89996707,-5,5,-1,198
3669,AgenteBasico,89996707,89996712,5,5,1,193
3670,AgenteBasico,89996712,89996712,0,5,0,187
3671,AgenteBasico,89996712,89996707,-5,5,-1,183
3672,AgenteBasico,89996707,89996697,-10,10,-1,179
3673,AgenteBasico,89996697,89996692,-5,5,-1,173
3674,AgenteBasico,89996692,89996687,-5,5,-1,167
3675,AgenteBasico,89996687,89996687,0,5,0,161
3676,AgenteBasico,89996687,89996682,-5,5,-1,157
3677,AgenteBasico,89996682,89996687,5,5,1,152
3678,AgenteBasico,89996687,89996692,5,5,1,147
3679,AgenteBasico,89996692,89996697,5,5,1,142
3680,AgenteBasico,89996697,89996702,5,5,1,137
3681,AgenteBasico,89996702,89996707,5,5,1,130
3682,AgenteBasico,89996707,89996702,-5,5,-1,124
3683,AgenteBasico,89996702,89996702,0,10,0,119
3684,AgenteBasico,89996702,89996707,5,5,1,113
3685,AgenteBasico,89996707,89996702,-5,5,-1,108
3686,AgenteBasico,89996702,89996707,5,5,1,102
3687,AgenteBasico,89996707,89996707,0,5,0,96
3688,AgenteBasico,89996707,89996714,7,5,1,92
3689,AgenteBasico,89996714,89996714,0,5,0,86
3690,AgenteBasico,89996714,89996709,-5,5,-1,82
3691,AgenteBasico,89996709,89996716,7,5,1,75
3692,AgenteBasico,89996716,89996706,-10,10,-1,71
3693,AgenteBasico,89996706,89996703,-3,0,-1,65
3694,AgenteBasico,89996703,89996703,0,5,0,60
3695,AgenteBasico,89996703,89996708,5,5,1,54
3696,AgenteBasico,89996708,89996703,-5,5,-1,48
3697,AgenteBasico,89996703,89996708,5,5,1,43
3698,AgenteBasico,89996708,89996703,-5,5,-1,38
3699,AgenteBasico,89996703,89996698,-5,5,-1,33
3700,AgenteBasico,89996698,89996688,-10,10,-1,202
3701,AgenteBasico,89996688,89996683,-5,5,-1,196
3702,AgenteBasico,89996683,89996678,-5,5,-1,190
3703,AgenteBasico,89996678,89996683,5,5,1,184
3704,AgenteBasico,89996683,89996673,-10,10,-1,177
3705,AgenteBasico,89996673,89996663,-10,10,-1,172
3706,AgenteBasico,89996663,89996660,-3,0,-1,166
3707,AgenteBasico,89996660,89996655,-5,5,-1,162
3708,AgenteBasico,89996655,89996685,30,30,1,156
3709,AgenteBasico,89996685,89996685,0,5,0,138
3710,AgenteBasico,89996685,89996685,0,5,0,133
3711,AgenteBasico,89996685,89996685,0,5,0,126
3712,AgenteBasico,89996685,89996685,0,5,0,121
3713,AgenteBasico,89996685,89996680,-5,5,-1,116
3714,AgenteBasico,89996680,89996685,5,5,1,111
3715,AgenteBasico,89996685,89996675,-10,10,-1,106
3716,AgenteBasico,89996675,89996680,5,5,1,98
3717,AgenteBasico,89996680,89996675,-5,5,-1,92
3718,AgenteBasico,89996675,89996680,5,5,1,86
3719,AgenteBasico,89996680,89996687,7,5,1,81
3720,AgenteBasico,89996687,89996697,10,10,1,75
3721,AgenteBasico,89996697,89996702,5,5,1,68
3722,AgenteBasico,89996702,89996697,-5,5,-1,63
3723,AgenteBasico,89996697,89996692,-5,5,-1,57
3724,AgenteBasico,89996692,89996687,-5,5,-1,51
3725,AgenteBasico,89996687,89996682,-5,5,-1,202
3726,AgenteBasico,89996682,89996682,0,5,0,198
3727,AgenteBasico,89996682,89996677,-5,5,-1,192
3728,AgenteBasico,89996677,89996672,-5,5,-1,187
3729,AgenteBasico,89996672,89996677,5,5,1,182
3730,AgenteBasico,89996677,89996672,-5,5,-1,177
3731,AgenteBasico,89996672,89996677,5,5,1,172
3732,AgenteBasico,89996677,89996672,-5,5,-1,166
3733,AgenteBasico,89996672,89996672,0,5,0,160
3734,AgenteBasico,89996672,89996682,10,10,1,155
3735,AgenteBasico,89996682,89996672,-10,10,-1,149
3736,AgenteBasico,89996672,89996679,7,5,1,143
3737,AgenteBasico,89996679,89996674,-5,5,-1,139
3738,AgenteBasico,89996674,89996669,-5,5,-1,132
3739,AgenteBasico,89996669,89996664,-5,5,-1,125
3740,AgenteBasico,89996664,89996669,5,5,1,120
3741,AgenteBasico,89996669,89996669,0,5,0,113
3742,AgenteBasico,89996669,89996664,-5,5,-1,106
3743,AgenteBasico,89996664,89996664,0,10,0,100
3744,AgenteBasico,89996664,89996664,0,5,0,95
3745,AgenteBasico,89996664,89996671,7,5,1,90
3746,AgenteBasico,89996671,89996666,-5,5,-1,85
3747,AgenteBasico,89996666,89996671,5,5,1,81
3748,AgenteBasico,89996671,89996671,0,5,0,73
3749,AgenteBasico,89996671,89996661,-10,10,-1,68
3750,AgenteBasico,89996661,89996671,10,10,1,63
3751,AgenteBasico,89996671,89996678,7,5,1,57
3752,AgenteBasico,89996678,89996683,5,5,1,52
3753,AgenteBasico,89996683,89996680,-3,0,-1,47
3754,AgenteBasico,89996680,89996675,-5,5,-1,43
3755,AgenteBasico,89996675,89996675,0,10,0,38
3756,AgenteBasico,89996675,89996670,-5,5,-1,201
3757,AgenteBasico,89996670,89996667,-3,0,-1,196
3758,AgenteBasico,89996667,89996657,-10,10,-1,192
3759,AgenteBasico,89996657,89996667,10,10,1,187
3760,AgenteBasico,89996667,89996662,-5,5,-1,180
3761,AgenteBasico,89996662,89996667,5,5,1,176
3762,AgenteBasico,89996667,89996657,-10,10,-1,170
3763,AgenteBasico,89996657,89996662,5,5,1,164
3764,AgenteBasico,89996662,89996669,7,5,1,158
3765,AgenteBasico,89996669,89996664,-5,5,-1,152
3766,AgenteBasico,89996664,89996659,-5,5,-1,147
3767,AgenteBasico,89996659,89996659,0,10,0,142
3768,AgenteBasico,89996659,89996649,-10,10,-1,137
3769,AgenteBasico,89996649,89996656,7,5,1,131
3770,AgenteBasico,89996656,89996661,5,5,1,127
3771,AgenteBasico,89996661,89996656,-5,5,-1,122
3772,AgenteBasico,89996656,89996651,-5,5,-1,117
3773,AgenteBasico,89996651,89996651,0,5,0,111
3774,AgenteBasico,89996651,89996651,0,5,0,106
3775,AgenteBasico,89996651,89996646,-5,5,-1,101
3776,AgenteBasico,89996646,89996641,-5,5,-1,95
3777,AgenteBasico,89996641,89996641,0,5,0,90
3778,AgenteBasico,89996641,89996636,-5,5,-1,85
3779,AgenteBasico,89996636,89996631,-5,5,-1,80
3780,AgenteBasico,89996631,89996636,5,5,1,74
3781,AgenteBasico,89996636,89996631,-5,5,-1,69
3782,AgenteBasico,89996631,89996626,-5,5,-1,62
3783,AgenteBasico,89996626,89996633,7,5,1,58
3784,AgenteBasico,89996633,89996628,-5,5,-1,54
3785,AgenteBasico,89996628,89996623,-5,5,-1,48
3786,AgenteBasico,89996623,89996618,-5,5,-1,43
3787,AgenteBasico,89996618,89996623,5,5,1,38
3788,AgenteBasico,89996623,89996623,0,5,0,32
3789,AgenteBasico,89996623,89996613,-10,10,-1,203
3790,AgenteBasico,89996613,89996610,-3,0,-1,197
3791,AgenteBasico,89996610,89996607,-3,0,-1,192
3792,AgenteBasico,89996607,89996602,-5,5,-1,187
3793,AgenteBasico,89996602,89996602,0,5,0,182
3794,AgenteBasico,89996602,89996599,-3,0,-1,177
3795,AgenteBasico,89996599,89996594,-5,5,-1,172
3796,AgenteBasico,89996594,89996589,-5,5,-1,166
3797,AgenteBasico,89996589,89996594,5,5,1,160
3798,AgenteBasico,89996594,89996589,-5,5,-1,155
3799,AgenteBasico,89996589,89996586,-3,0,-1,150
3800,AgenteBasico,89996586,89996591,5,5,1,146
3801,AgenteBasico,89996591,89996586,-5,5,-1,139
3802,AgenteBasico,89996586,89996581,-5,5,-1,131
3803,AgenteBasico,89996581,89996576,-5,5,-1,124
3804,AgenteBasico,89996576,89996566,-10,10,-1,119
3805,AgenteBasico,89996566,89996566,0,5,0,113
3806,AgenteBasico,89996566,89996566,0,5,0,106
3807,AgenteBasico,89996566,89996576,10,10,1,100
3808,AgenteBasico,89996576,89996576,0,5,0,92
3809,AgenteBasico,89996576,89996583,7,5,1,88
3810,AgenteBasico,89996583,89996588,5,5,1,84
3811,AgenteBasico,89996588,89996583,-5,5,-1,77
3812,AgenteBasico,89996583,89996583,0,5,0,72
3813,AgenteBasico,89996583,89996578,-5,5,-1,67
3814,AgenteBasico,89996578,89996568,-10,10,-1,60
3815,AgenteBasico,89996568,89996563,-5,5,-1,55
3816,AgenteBasico,89996563,89996558,-5,5,-1,48
3817,AgenteBasico,89996558,89996553,-5,5,-1,202
3818,AgenteBasico,89996553,89996550,-3,0,-1,197
3819,AgenteBasico,89996550,89996540,-10,10,-1,193
3820,AgenteBasico,89996540,89996540,0,5,0,187
3821,AgenteBasico,89996540,89996537,-3,0,-1,181
3822,AgenteBasico,89996537,89996532,-5,5,-1,176
3823,AgenteBasico,89996532,89996537,5,5,1,172
3824,AgenteBasico,89996537,89996542,5,5,1,166
3825,AgenteBasico,89996542,89996542,0,10,0,158
3826,AgenteBasico,89996542,89996557,15,15,1,153
3827,AgenteBasico,89996557,89996552,-5,5,-1,145
3828,AgenteBasico,89996552,89996552,0,5,0,140
3829,AgenteBasico,89996552,89996547,-5,5,-1,136
3830,AgenteBasico,89996547,89996542,-5,5,-1,129
3831,AgenteBasico,89996542,89996549,7,5,1,122
3832,AgenteBasico,89996549,89996549,0,5,0,118
3833,AgenteBasico,89996549,89996549,0,5,0,112
3834,AgenteBasico,89996549,89996549,0,5,0,107
3835,AgenteBasico,89996549,89996554,5,5,1,101
3836,AgenteBasico,89996554,89996554,0,5,0,96
3837,AgenteBasico,89996554,89996549,-5,5,-1,91
3838,AgenteBasico,89996549,89996549,0,5,0,86
3839,AgenteBasico,89996549,89996544,-5,5,-1,79
3840,AgenteBasico,89996544,89996541,-3,0,-1,73
3841,AgenteBasico,89996541,89996546,5,5,1,69
3842,AgenteBasico,89996546,89996541,-5,5,-1,64
3843,AgenteBasico,89996541,89996546,5,5,1,58
3844,AgenteBasico,89996546,89996551,5,5,1,51
3845,AgenteBasico,89996551,89996546,-5,5,-1,46
3846,AgenteBasico,89996546,89996541,-5,5,-1,38
3847,AgenteBasico,89996541,89996546,5,5,1,201
3848,AgenteBasico,89996546,89996546,0,5,0,196
3849,AgenteBasico,89996546,89996546,0,10,0,192
3850,AgenteBasico,89996546,89996541,-5,5,-1,186
3851,AgenteBasico,89996541,89996541,0,5,0,180
3852,AgenteBasico,89996541,89996536,-5,5,-1,176
3853,AgenteBasico,89996536,89996541,5,5,1,170
3854,AgenteBasico,89996541,89996538,-3,0,-1,163
3855,AgenteBasico,89996538,89996545,7,5,1,158
3856,AgenteBasico,89996545,89996542,-3,0,-1,153
3857,AgenteBasico,89996542,89996547,5,5,1,149
3858,AgenteBasico,89996547,89996544,-3,0,-1,144
3859,AgenteBasico,89996544,89996544,0,10,0,139
3860,AgenteBasico,89996544,89996549,5,5,1,133
3861,AgenteBasico,89996549,89996554,5,5,1,128
3862,AgenteBasico,89996554,89996554,0,5,0,123
3863,AgenteBasico,89996554,89996549,-5,5,-1,119
3864,AgenteBasico,89996549,89996539,-10,10,-1,114
3865,AgenteBasico,89996539,89996544,5,5,1,109
3866,AgenteBasico,89996544,89996544,0,5,0,101
3867,AgenteBasico,89996544,89996554,10,10,1,96
3868,AgenteBasico,89996554,89996549,-5,5,-1,89
3869,AgenteBasico,89996549,89996539,-10,10,-1,83
3870,AgenteBasico,89996539,89996544,5,5,1,77
3871,AgenteBasico,89996544,89996539,-5,5,-1,70
3872,AgenteBasico,89996539,89996534,-5,5,-1,64
3873,AgenteBasico,89996534,89996534,0,5,0,58
3874,AgenteBasico,89996534,89996529,-5,5,-1,52
3875,AgenteBasico,89996529,89996524,-5,5,-1,48
3876,AgenteBasico,89996524,89996529,5,5,1,42
3877,AgenteBasico,89996529,89996529,0,5,0,202
3878,AgenteBasico,89996529,89996524,-5,5,-1,196
3879,AgenteBasico,89996524,89996531,7,5,1,191
3880,AgenteBasico,89996531,89996526,-5,5,-1,186
3881,AgenteBasico,89996526,89996521,-5,5,-1,182
3882,AgenteBasico,89996521,89996516,-5,5,-1,176
3883,AgenteBasico,89996516,89996521,5,5,1,171
3884,AgenteBasico,89996521,89996518,-3,0,-1,164
3885,AgenteBasico,89996518,89996518,0,5,0,159
3886,AgenteBasico,89996518,89996513,-5,5,-1,155
3887,AgenteBasico,89996513,89996518,5,5,1,150
3888,AgenteBasico,89996518,89996513,-5,5,-1,143
3889,AgenteBasico,89996513,89996513,0,5,0,138
3890,AgenteBasico,89996513,89996508,-5,5,-1,132
3891,AgenteBasico,89996508,89996503,-5,5,-1,125
3892,AgenteBasico,89996503,89996503,0,5,0,117
3893,AgenteBasico,89996503,89996498,-5,5,-1,111
3894,AgenteBasico,89996498,89996493,-5,5,-1,107
3895,AgenteBasico,89996493,89996488,-5,5,-1,101
3896,AgenteBasico,89996488,89996488,0,5,0,95
3897,AgenteBasico,89996488,89996488,0,5,0,91
3898,AgenteBasico,89996488,89996483,-5,5,-1,86
3899,AgenteBasico,89996483,89996493,10,10,1,79
3900,AgenteBasico,89996493,89996488,-5,5,-1,71
3901,AgenteBasico,89996488,89996488,0,5,0,63
3902,AgenteBasico,89996488,89996488,0,5,0,58
3903,AgenteBasico,89996488,89996483,-5,5,-1,52
3904,AgenteBasico,89996483,89996478,-5,5,-1,47
3905,AgenteBasico,89996478,89996473,-5,5,-1,41
3906,AgenteBasico,89996473,89996473,0,10,0,37
3907,AgenteBasico,89996473,89996473,0,5,0,32
3908,AgenteBasico,89996473,89996468,-5,5,-1,204
3909,AgenteBasico,89996468,89996473,5,5,1,197
3910,AgenteBasico,89996473,89996468,-5,5,-1,189
3911,AgenteBasico,89996468,89996468,0,10,0,184
3912,AgenteBasico,89996468,89996463,-5,5,-1,179
3913,AgenteBasico,89996463,89996470,7,5,1,172
3914,AgenteBasico,89996470,89996465,-5,5,-1,168
3915,AgenteBasico,89996465,89996460,-5,5,-1,164
3916,AgenteBasico,89996460,89996465,5,5,1,157
3917,AgenteBasico,89996465,89996470,5,5,1,152
3918,AgenteBasico,89996470,89996477,7,5,1,146
3919,AgenteBasico,89996477,89996477,0,5,0,141
3920,AgenteBasico,89996477,89996472,-5,5,-1,136
3921,AgenteBasico,89996472,89996477,5,5,1,131
3922,AgenteBasico,89996477,89996472,-5,5,-1,126
3923,AgenteBasico,89996472,89996467,-5,5,-1,121
3924,AgenteBasico,89996467,89996462,-5,5,-1,114
3925,AgenteBasico,89996462,89996467,5,5,1,108
3926,AgenteBasico,89996467,89996462,-5,5,-1,101
3927,AgenteBasico,89996462,89996457,-5,5,-1,96
3928,AgenteBasico,89996457,89996457,0,5,0,89
3929,AgenteBasico,89996457,89996457,0,10,0,85
3930,AgenteBasico,89996457,89996452,-5,5,-1,79
3931,AgenteBasico,89996452,89996457,5,5,1,74
3932,AgenteBasico,89996457,89996457,0,5,0,68
3933,AgenteBasico,89996457,89996457,0,5,0,61
3934,AgenteBasico,89996457,89996452,-5,5,-1,57
3935,AgenteBasico,89996452,89996447,-5,5,-1,52
3936,AgenteBasico,89996447,89996437,-10,10,-1,46
3937,AgenteBasico,89996437,89996432,-5,5,-1,39
3938,AgenteBasico,89996432,89996429,-3,0,-1,32
3939,AgenteBasico,89996429,89996429,0,5,0,203
3940,AgenteBasico,89996429,89996429,0,5,0,198
3941,AgenteBasico,89996429,89996424,-5,5,-1,193
3942,AgenteBasico,89996424,89996419,-5,5,-1,187
3943,AgenteBasico,89996419,89996424,5,5,1,181
3944,AgenteBasico,89996424,89996424,0,5,0,176
3945,AgenteBasico,89996424,89996419,-5,5,-1,172
3946,AgenteBasico,89996419,89996414,-5,5,-1,166
3947,AgenteBasico,89996414,89996414,0,5,0,159
3948,AgenteBasico,89996414,89996419,5,5,1,154
3949,AgenteBasico,89996419,89996424,5,5,1,148
3950,AgenteBasico,89996424,89996429,5,5,1,142
3951,AgenteBasico,89996429,89996429,0,5,0,135
3952,AgenteBasico,89996429,89996419,-10,10,-1,129
3953,AgenteBasico,89996419,89996419,0,5,0,124
3954,AgenteBasico,89996419,89996424,5,5,1,119
3955,AgenteBasico,89996424,89996424,0,10,0,114
3956,AgenteBasico,89996424,89996414,-10,10,-1,107
3957,AgenteBasico,89996414,89996421,7,5,1,101
3958,AgenteBasico,89996421,89996421,0,5,0,95
3959,AgenteBasico,89996421,89996416,-5,5,-1,90
3960,AgenteBasico,89996416,89996413,-3,0,-1,86
3961,AgenteBasico,89996413,89996408,-5,5,-1,82
3962,AgenteBasico,89996408,89996405,-3,0,-1,75
3963,AgenteBasico,89996405,89996410,5,5,1,71
3964,AgenteBasico,89996410,89996405,-5,5,-1,66
3965,AgenteBasico,89996405,89996410,5,5,1,61
3966,AgenteBasico,89996410,89996415,5,5,1,55
3967,AgenteBasico,89996415,89996410,-5,5,-1,50
3968,AgenteBasico,89996410,89996410,0,5,0,43
3969,AgenteBasico,89996410,89996405,-5,5,-1,38
3970,AgenteBasico,89996405,89996405,0,5,0,30
3971,AgenteBasico,89996405,89996410,5,5,1,203
3972,AgenteBasico,89996410,89996415,5,5,1,197
3973,AgenteBasico,89996415,89996410,-5,5,-1,190
3974,AgenteBasico,89996410,89996405,-5,5,-1,185
3975,AgenteBasico,89996405,89996400,-5,15,-1,179
3976,AgenteBasico,89996400,89996400,0,10,0,171
3977,AgenteBasico,89996400,89996390,-10,10,-1,165
3978,AgenteBasico,89996390,89996390,0,5,0,159
3979,AgenteBasico,89996390,89996385,-5,5,-1,153
3980,AgenteBasico,89996385,89996380,-5,5,-1,149
3981,AgenteBasico,89996380,89996385,5,5,1,144
3982,AgenteBasico,89996385,89996380,-5,5,-1,138
3983,AgenteBasico,89996380,89996385,5,5,1,131
3984,AgenteBasico,89996385,89996385,0,5,0,126
3985,AgenteBasico,89996385,89996380,-5,5,-1,119
3986,AgenteBasico,89996380,89996375,-5,5,-1,115
3987,AgenteBasico,89996375,89996370,-5,5,-1,110
3988,AgenteBasico,89996370,89996365,-5,5,-1,106
3989,AgenteBasico,89996365,89996360,-5,5,-1,99
3990,AgenteBasico,89996360,89996355,-5,5,-1,94
3991,AgenteBasico,89996355,89996360,5,5,1,86
3992,AgenteBasico,89996360,89996355,-5,5,-1,80
3993,AgenteBasico,89996355,89996350,-5,5,-1,75
3994,AgenteBasico,89996350,89996345,-5,5,-1,70
3995,AgenteBasico,89996345,89996340,-5,5,-1,65
3996,AgenteBasico,89996340,89996335,-5,5,-1,58
3997,AgenteBasico,89996335,89996335,0,5,0,53
3998,AgenteBasico,89996335,89996332,-3,0,-1,48
3999,AgenteBasico,89996332,89996322,-10,10,-1,44
4000,AgenteBasico,89996322,89996322,0,5,0,38
4001,AgenteBasico,89996322,89996327,5,5,1,34
4002,AgenteBasico,89996327,89996322,-5,5,-1,29
4003,AgenteBasico,89996322,89996317,-5,5,-1,202
4004,AgenteBasico,89996317,89996312,-5,5,-1,196
4005,AgenteBasico,89996312,89996307,-5,5,-1,190
4006,AgenteBasico,89996307,89996307,0,5,0,185
4007,AgenteBasico,89996307,89996307,0,10,0,180
4008,AgenteBasico,89996307,89996312,5,5,1,175
4009,AgenteBasico,89996312,89996317,5,5,1,167
4010,AgenteBasico,89996317,89996322,5,5,1,162
4011,AgenteBasico,89996322,89996332,10,10,1,157
4012,AgenteBasico,89996332,89996332,0,5,0,150
4013,AgenteBasico,89996332,89996327,-5,5,-1,145
4014,AgenteBasico,89996327,89996322,-5,5,-1,140
4015,AgenteBasico,89996322,89996322,0,10,0,134
4016,AgenteBasico,89996322,89996317,-5,5,-1,129
4017,AgenteBasico,89996317,89996312,-5,5,-1,121
4018,AgenteBasico,89996312,89996302,-10,10,-1,116
4019,AgenteBasico,89996302,89996299,-3,0,-1,110
4020,AgenteBasico,89996299,89996294,-5,5,-1,106
4021,AgenteBasico,89996294,89996294,0,10,0,100
4022,AgenteBasico,89996294,89996289,-5,5,-1,94
4023,AgenteBasico,89996289,89996284,-5,5,-1,90
4024,AgenteBasico,89996284,89996284,0,5,0,82
4025,AgenteBasico,89996284,89996284,0,5,0,76
4026,AgenteBasico,89996284,89996289,5,5,1,72
4027,AgenteBasico,89996289,89996294,5,5,1,65
4028,AgenteBasico,89996294,89996289,-5,5,-1,60
4029,AgenteBasico,89996289,89996296,7,5,1,55
4030,AgenteBasico,89996296,89996293,-3,0,-1,50
4031,AgenteBasico,89996293,89996288,-5,5,-1,44
4032,AgenteBasico,89996288,89996283,-5,5,-1,39
4033,AgenteBasico,89996283,89996280,-3,0,-1,33
4034,AgenteBasico,89996280,89996285,5,5,1,29
4035,AgenteBasico,89996285,89996290,5,5,1,203
4036,AgenteBasico,89996290,89996290,0,10,0,198
4037,AgenteBasico,89996290,89996285,-5,5,-1,192
4038,AgenteBasico,89996285,89996292,7,5,1,185
4039,AgenteBasico,89996292,89996287,-5,5,-1,180
4040,AgenteBasico,89996287,89996292,5,5,1,175
4041,AgenteBasico,89996292,89996282,-10,10,-1,168
4042,AgenteBasico,89996282,89996287,5,5,1,163
4043,AgenteBasico,89996287,89996287,0,10,0,157
4044,AgenteBasico,89996287,89996292,5,5,1,151
4045,AgenteBasico,89996292,89996292,0,5,0,145
4046,AgenteBasico,89996292,89996287,-5,5,-1,139
4047,AgenteBasico,89996287,89996282,-5,5,-1,133
4048,AgenteBasico,89996282,89996277,-5,5,-1,128
4049,AgenteBasico,89996277,89996272,-5,5,-1,121
4050,AgenteBasico,89996272,89996277,5,5,1,115
4051,AgenteBasico,89996277,89996277,0,5,0,110
4052,AgenteBasico,89996277,89996272,-5,5,-1,106
4053,AgenteBasico,89996272,89996279,7,5,1,100
4054,AgenteBasico,89996279,89996269,-10,10,-1,96
4055,AgenteBasico,89996269,89996259,-10,10,-1,90
4056,AgenteBasico,89996259,89996264,5,5,1,85
4057,AgenteBasico,89996264,89996269,5,5,1,80
4058,AgenteBasico,89996269,89996279,10,10,1,75
4059,AgenteBasico,89996279,89996274,-5,5,-1,69
4060,AgenteBasico,89996274,89996271,-3,0,-1,63
4061,AgenteBasico,89996271,89996271,0,5,0,58
4062,AgenteBasico,89996271,89996281,10,10,1,52
4063,AgenteBasico,89996281,89996281,0,5,0,46
4064,AgenteBasico,89996281,89996276,-5,5,-1,42
4065,AgenteBasico,89996276,89996266,-10,10,-1,38
4066,AgenteBasico,89996266,89996271,5,5,1,31
4067,AgenteBasico,89996271,89996266,-5,5,-1,200
4068,AgenteBasico,89996266,89996271,5,5,1,195
4069,AgenteBasico,89996271,89996266,-5,5,-1,190
4070,AgenteBasico,89996266,89996266,0,5,0,185
4071,AgenteBasico,89996266,89996261,-5,5,-1,179
4072,AgenteBasico,89996261,89996266,5,5,1,174
4073,AgenteBasico,89996266,89996261,-5,5,-1,168
4074,AgenteBasico,89996261,89996261,0,5,0,162
4075,AgenteBasico,89996261,89996261,0,5,0,158
4076,AgenteBasico,89996261,89996256,-5,5,-1,150
4077,AgenteBasico,89996256,89996256,0,5,0,145
4078,AgenteBasico,89996256,89996256,0,5,0,141
4079,AgenteBasico,89996256,89996251,-5,5,-1,137
4080,AgenteBasico,89996251,89996251,0,5,0,131
4081,AgenteBasico,89996251,89996246,-5,5,-1,126
4082,AgenteBasico,89996246,89996236,-10,10,-1,120
4083,AgenteBasico,89996236,89996226,-10,10,-1,115
4084,AgenteBasico,89996226,89996221,-5,5,-1,109
4085,AgenteBasico,89996221,89996216,-5,5,-1,103
4086,AgenteBasico,89996216,89996211,-5,5,-1,97
4087,AgenteBasico,89996211,89996216,5,5,1,92
4088,AgenteBasico,89996216,89996211,-5,5,-1,87
4089,AgenteBasico,89996211,89996206,-5,5,-1,82
4090,AgenteBasico,89996206,89996206,0,5,0,76
4091,AgenteBasico,89996206,89996216,10,10,1,71
4092,AgenteBasico,89996216,89996223,7,5,1,64
4093,AgenteBasico,89996223,89996218,-5,5,-1,58
4094,AgenteBasico,89996218,89996213,-5,5,-1,53
4095,AgenteBasico,89996213,89996213,0,5,0,45
4096,AgenteBasico,89996213,89996218,5,5,1,203
4097,AgenteBasico,89996218,89996218,0,5,0,197
4098,AgenteBasico,89996218,89996213,-5,5,-1,193
4099,AgenteBasico,89996213,89996208,-5,5,-1,187
4100,AgenteBasico,89996208,89996223,15,15,1,182
4101,AgenteBasico,89996223,89996223,0,5,0,172
4102,AgenteBasico,89996223,89996228,5,5,1,163
4103,AgenteBasico,89996228,89996228,0,5,0,158
4104,AgenteBasico,89996228,89996223,-5,5,-1,154
4105,AgenteBasico,89996223,89996233,10,10,1,149
4106,AgenteBasico,89996233,89996233,0,5,0,143
4107,AgenteBasico,89996233,89996238,5,5,1,137
4108,AgenteBasico,89996238,89996238,0,5,0,130
4109,AgenteBasico,89996238,89996243,5,5,1,126
4110,AgenteBasico,89996243,89996238,-5,5,-1,120
4111,AgenteBasico,89996238,89996233,-5,5,-1,115
4112,AgenteBasico,89996233,89996240,7,5,1,110
4113,AgenteBasico,89996240,89996235,-5,5,-1,105
4114,AgenteBasico,89996235,89996230,-5,5,-1,98
4115,AgenteBasico,89996230,89996225,-5,5,-1,92
4116,AgenteBasico,89996225,89996225,0,10,0,87
4117,AgenteBasico,89996225,89996230,5,5,1,82
4118,AgenteBasico,89996230,89996240,10,10,1,77
4119,AgenteBasico,89996240,89996235,-5,5,-1,70
4120,AgenteBasico,89996235,89996242,7,5,1,65
4121,AgenteBasico,89996242,89996242,0,5,0,60
4122,AgenteBasico,89996242,89996237,-5,5,-1,55
4123,AgenteBasico,89996237,89996237,0,5,0,48
4124,AgenteBasico,89996237,89996232,-5,5,-1,44
4125,AgenteBasico,89996232,89996237,5,5,1,38
4126,AgenteBasico,89996237,89996234,-3,0,-1,33
4127,AgenteBasico,89996234,89996229,-5,5,-1,204
4128,AgenteBasico,89996229,89996224,-5,5,-1,198
4129,AgenteBasico,89996224,89996229,5,5,1,191
4130,AgenteBasico,89996229,89996234,5,5,1,186
4131,AgenteBasico,89996234,89996224,-10,10,-1,180
4132,AgenteBasico,89996224,89996219,-5,5,-1,174
4133,AgenteBasico,89996219,89996214,-5,5,-1,170
4134,AgenteBasico,89996214,89996214,0,5,0,165
4135,AgenteBasico,89996214,89996214,0,5,0,159
4136,AgenteBasico,89996214,89996214,0,10,0,155
4137,AgenteBasico,89996214,89996219,5,5,1,149
4138,AgenteBasico,89996219,89996214,-5,5,-1,142
4139,AgenteBasico,89996214,89996219,5,5,1,138
4140,AgenteBasico,89996219,89996214,-5,5,-1,133
4141,AgenteBasico,89996214,89996209,-5,5,-1,127
4142,AgenteBasico,89996209,89996214,5,5,1,121
4143,AgenteBasico,89996214,89996214,0,10,0,116
4144,AgenteBasico,89996214,89996204,-10,10,-1,111
4145,AgenteBasico,89996204,89996204,0,5,0,103
4146,AgenteBasico,89996204,89996209,5,5,1,99
4147,AgenteBasico,89996209,89996214,5,5,1,92
4148,AgenteBasico,89996214,89996214,0,5,0,87
4149,AgenteBasico,89996214,89996214,0,5,0,83
4150,AgenteBasico,89996214,89996209,-5,5,-1,77
4151,AgenteBasico,89996209,89996209,0,5,0,70
4152,AgenteBasico,89996209,89996209,0,5,0,64
4153,AgenteBasico,89996209,89996214,5,5,1,59
4154,AgenteBasico,89996214,89996214,0,5,0,53
4155,AgenteBasico,89996214,89996214,0,5,0,45
4156,AgenteBasico,89996214,89996209,-5,5,-1,202
4157,AgenteBasico,89996209,89996209,0,5,0,197
4158,AgenteBasico,89996209,89996209,0,5,0,193
4159,AgenteBasico,89996209,89996216,7,5,1,189
4160,AgenteBasico,89996216,89996216,0,5,0,185
4161,AgenteBasico,89996216,89996221,5,5,1,180
4162,AgenteBasico,89996221,89996216,-5,5,-1,175
4163,AgenteBasico,89996216,89996221,5,5,1,171
4164,AgenteBasico,89996221,89996226,5,5,1,165
4165,AgenteBasico,89996226,89996236,10,10,1,160
4166,AgenteBasico,89996236,89996243,7,5,1,154
4167,AgenteBasico,89996243,89996243,0,10,0,149
4168,AgenteBasico,89996243,89996233,-10,10,-1,142
4169,AgenteBasico,89996233,89996233,0,5,0,137
4170,AgenteBasico,89996233,89996233,0,5,0,131
4171,AgenteBasico,89996233,89996228,-5,5,-1,126
4172,AgenteBasico,89996228,89996223,-5,5,-1,121
4173,AgenteBasico,89996223,89996218,-5,5,-1,114
4174,AgenteBasico,89996218,89996218,0,5,0,109
4175,AgenteBasico,89996218,89996208,-10,10,-1,102
4176,AgenteBasico,89996208,89996203,-5,5,-1,96
4177,AgenteBasico,89996203,89996203,0,5,0,90
4178,AgenteBasico,89996203,89996208,5,5,1,83
4179,AgenteBasico,89996208,89996208,0,5,0,78
4180,AgenteBasico,89996208,89996198,-10,10,-1,72
4181,AgenteBasico,89996198,89996205,7,5,1,65
4182,AgenteBasico,89996205,89996205,0,5,0,59
4183,AgenteBasico,89996205,89996200,-5,5,-1,54
4184,AgenteBasico,89996200,89996195,-5,5,-1,49
4185,AgenteBasico,89996195,89996190,-5,5,-1,42
4186,AgenteBasico,89996190,89996190,0,5,0,36
4187,AgenteBasico,89996190,89996190,0,5,0,29
4188,AgenteBasico,89996190,89996195,5,5,1,204
4189,AgenteBasico,89996195,89996195,0,5,0,198
4190,AgenteBasico,89996195,89996190,-5,5,-1,194
4191,AgenteBasico,89996190,89996185,-5,5,-1,190
4192,AgenteBasico,89996185,89996190,5,5,1,186
4193,AgenteBasico,89996190,89996190,0,5,0,179
4194,AgenteBasico,89996190,89996190,0,5,0,172
4195,AgenteBasico,89996190,89996185,-5,5,-1,167
4196,AgenteBasico,89996185,89996180,-5,5,-1,161
4197,AgenteBasico,89996180,89996187,7,5,1,156
4198,AgenteBasico,89996187,89996192,5,5,1,150
4199,AgenteBasico,89996192,89996187,-5,5,-1,143
4200,AgenteBasico,89996187,89996182,-5,5,-1,138
4201,AgenteBasico,89996182,89996182,0,5,0,132
4202,AgenteBasico,89996182,89996192,10,10,1,128
4203,AgenteBasico,89996192,89996192,0,5,0,120
4204,AgenteBasico,89996192,89996187,-5,5,-1,114
4205,AgenteBasico,89996187,89996192,5,5,1,108
4206,AgenteBasico,89996192,89996199,7,5,1,103
4207,AgenteBasico,89996199,89996204,5,5,1,98
4208,AgenteBasico,89996204,89996199,-5,5,-1,93
4209,AgenteBasico,89996199,89996196,-3,0,-1,88
4210,AgenteBasico,89996196,89996196,0,15,0,84
4211,AgenteBasico,89996196,89996193,-3,0,-1,77
4212,AgenteBasico,89996193,89996203,10,10,1,72
4213,AgenteBasico,89996203,89996198,-5,5,-1,66
4214,AgenteBasico,89996198,89996193,-5,5,-1,59
4215,AgenteBasico,89996193,89996193,0,5,0,52
4216,AgenteBasico,89996193,89996188,-5,5,-1,45
4217,AgenteBasico,89996188,89996188,0,5,0,203
4218,AgenteBasico,89996188,89996183,-5,5,-1,197
4219,AgenteBasico,89996183,89996178,-5,5,-1,190
4220,AgenteBasico,89996178,89996185,7,5,1,186
4221,AgenteBasico,89996185,89996180,-5,5,-1,182
4222,AgenteBasico,89996180,89996180,0,5,0,177
4223,AgenteBasico,89996180,89996180,0,5,0,173
4224,AgenteBasico,89996180,89996180,0,5,0,167
4225,AgenteBasico,89996180,89996185,5,5,1,162
4226,AgenteBasico,89996185,89996180,-5,5,-1,156
4227,AgenteBasico,89996180,89996175,-5,5,-1,150
4228,AgenteBasico,89996175,89996170,-5,5,-1,143
4229,AgenteBasico,89996170,89996170,0,5,0,138
4230,AgenteBasico,89996170,89996170,0,5,0,134
4231,AgenteBasico,89996170,89996165,-5,5,-1,129
4232,AgenteBasico,89996165,89996162,-3,0,-1,123
4233,AgenteBasico,89996162,89996157,-5,5,-1,119
4234,AgenteBasico,89996157,89996164,7,5,1,114
4235,AgenteBasico,89996164,89996161,-3,0,-1,110
4236,AgenteBasico,89996161,89996166,5,5,1,106
4237,AgenteBasico,89996166,89996171,5,5,1,101
4238,AgenteBasico,89996171,89996161,-10,10,-1,96
4239,AgenteBasico,89996161,89996161,0,5,0,89
4240,AgenteBasico,89996161,89996161,0,5,0,85
4241,AgenteBasico,89996161,89996156,-5,5,-1,79
4242,AgenteBasico,89996156,89996156,0,5,0,74
4243,AgenteBasico,89996156,89996161,5,5,1,69
4244,AgenteBasico,89996161,89996156,-5,5,-1,63
4245,AgenteBasico,89996156,89996166,10,10,1,58
4246,AgenteBasico,89996166,89996156,-10,10,-1,52
4247,AgenteBasico,89996156,89996156,0,5,0,46
4248,AgenteBasico,89996156,89996156,0,5,0,41
4249,AgenteBasico,89996156,89996151,-5,5,-1,36
4250,AgenteBasico,89996151,89996141,-10,10,-1,204
4251,AgenteBasico,89996141,89996141,0,5,0,199
4252,AgenteBasico,89996141,89996146,5,5,1,194
4253,AgenteBasico,89996146,89996141,-5,5,-1,185
4254,AgenteBasico,89996141,89996146,5,5,1,179
4255,AgenteBasico,89996146,89996141,-5,5,-1,174
4256,AgenteBasico,89996141,89996136,-5,5,-1,169
4257,AgenteBasico,89996136,89996143,7,5,1,163
4258,AgenteBasico,89996143,89996148,5,5,1,159
4259,AgenteBasico,89996148,89996153,5,5,1,154
4260,AgenteBasico,89996153,89996148,-5,5,-1,149
4261,AgenteBasico,89996148,89996143,-5,5,-1,144
4262,AgenteBasico,89996143,89996143,0,5,0,138
4263,AgenteBasico,89996143,89996138,-5,5,-1,134
4264,AgenteBasico,89996138,89996135,-3,0,-1,126
4265,AgenteBasico,89996135,89996140,5,5,1,122
4266,AgenteBasico,89996140,89996150,10,10,1,116
4267,AgenteBasico,89996150,89996145,-5,5,-1,110
4268,AgenteBasico,89996145,89996150,5,5,1,104
4269,AgenteBasico,89996150,89996140,-10,10,-1,97
4270,AgenteBasico,89996140,89996145,5,5,1,92
4271,AgenteBasico,89996145,89996150,5,5,1,85
4272,AgenteBasico,89996150,89996145,-5,5,-1,79
4273,AgenteBasico,89996145,89996142,-3,0,-1,74
4274,AgenteBasico,89996142,89996137,-5,5,-1,70
4275,AgenteBasico,89996137,89996137,0,5,0,63
4276,AgenteBasico,89996137,89996142,5,5,1,59
4277,AgenteBasico,89996142,89996137,-5,5,-1,54
4278,AgenteBasico,89996137,89996137,0,5,0,49
4279,AgenteBasico,89996137,89996132,-5,5,-1,204
4280,AgenteBasico,89996132,89996127,-5,5,-1,195
4281,AgenteBasico,89996127,89996122,-5,5,-1,189
4282,AgenteBasico,89996122,89996122,0,5,0,184
4283,AgenteBasico,89996122,89996112,-10,10,-1,178
4284,AgenteBasico,89996112,89996112,0,5,0,171
4285,AgenteBasico,89996112,89996107,-5,5,-1,167
4286,AgenteBasico,89996107,89996102,-5,5,-1,159
4287,AgenteBasico,89996102,89996097,-5,5,-1,155
4288,AgenteBasico,89996097,89996097,0,5,0,150
4289,AgenteBasico,89996097,89996094,-3,0,-1,144
4290,AgenteBasico,89996094,89996099,5,5,1,139
4291,AgenteBasico,89996099,89996094,-5,5,-1,133
4292,AgenteBasico,89996094,89996089,-5,5,-1,128
4293,AgenteBasico,89996089,89996084,-5,5,-1,123
4294,AgenteBasico,89996084,89996079,-5,5,-1,117
4295,AgenteBasico,89996079,89996084,5,5,1,112
4296,AgenteBasico,89996084,89996079,-5,5,-1,107
4297,AgenteBasico,89996079,89996084,5,5,1,102
4298,AgenteBasico,89996084,89996091,7,5,1,96
4299,AgenteBasico,89996091,89996096,5,5,1,92
4300,AgenteBasico,89996096,89996101,5,5,1,86
4301,AgenteBasico,89996101,89996098,-3,0,-1,80
4302,AgenteBasico,89996098,89996108,10,10,1,74
4303,AgenteBasico,89996108,89996108,0,10,0,68
4304,AgenteBasico,89996108,89996103,-5,5,-1,62
4305,AgenteBasico,89996103,89996098,-5,5,-1,57
4306,AgenteBasico,89996098,89996093,-5,5,-1,51
4307,AgenteBasico,89996093,89996100,7,5,1,203
4308,AgenteBasico,89996100,89996100,0,5,0,199
4309,AgenteBasico,89996100,89996100,0,5,0,194
4310,AgenteBasico,89996100,89996100,0,10,0,190
4311,AgenteBasico,89996100,89996100,0,5,0,185
4312,AgenteBasico,89996100,89996090,-10,10,-1,178
4313,AgenteBasico,89996090,89996095,5,5,1,172
4314,AgenteBasico,89996095,89996090,-5,5,-1,166
4315,AgenteBasico,89996090,89996087,-3,0,-1,159
4316,AgenteBasico,89996087,89996092,5,5,1,152
4317,AgenteBasico,89996092,89996097,5,5,1,147
4318,AgenteBasico,89996097,89996097,0,5,0,141
4319,AgenteBasico,89996097,89996102,5,5,1,137
4320,AgenteBasico,89996102,89996092,-10,10,-1,131
4321,AgenteBasico,89996092,89996099,7,5,1,125
4322,AgenteBasico,89996099,89996104,5,5,1,120
4323,AgenteBasico,89996104,89996099,-5,5,-1,114
4324,AgenteBasico,89996099,89996104,5,5,1,108
4325,AgenteBasico,89996104,89996104,0,5,0,103
4326,AgenteBasico,89996104,89996111,7,5,1,98
4327,AgenteBasico,89996111,89996111,0,5,0,93
4328,AgenteBasico,89996111,89996106,-5,5,-1,83
4329,AgenteBasico,89996106,89996106,0,5,0,77
4330,AgenteBasico,89996106,89996101,-5,5,-1,70
4331,AgenteBasico,89996101,89996096,-5,5,-1,65
4332,AgenteBasico,89996096,89996091,-5,5,-1,59
4333,AgenteBasico,89996091,89996096,5,5,1,54
4334,AgenteBasico,89996096,89996101,5,5,1,48
4335,AgenteBasico,89996101,89996098,-3,0,-1,43
4336,AgenteBasico,89996098,89996093,-5,5,-1,38
4337,AgenteBasico,89996093,89996098,5,5,1,33
4338,AgenteBasico,89996098,89996093,-5,5,-1,202
4339,AgenteBasico,89996093,89996093,0,5,0,197
4340,AgenteBasico,89996093,89996098,5,5,1,191
4341,AgenteBasico,89996098,89996073,-25,35,-1,186
4342,AgenteBasico,89996073,89996073,0,5,0,170
4343,AgenteBasico,89996073,89996073,0,5,0,164
4344,AgenteBasico,89996073,89996063,-10,10,-1,158
4345,AgenteBasico,89996063,89996063,0,10,0,152
4346,AgenteBasico,89996063,89996070,7,5,1,145
4347,AgenteBasico,89996070,89996075,5,5,1,140
4348,AgenteBasico,89996075,89996070,-5,5,-1,135
4349,AgenteBasico,89996070,89996075,5,5,1,131
4350,AgenteBasico,89996075,89996070,-5,5,-1,125
4351,AgenteBasico,89996070,89996067,-3,0,-1,120
4352,AgenteBasico,89996067,89996067,0,5,0,114
4353,AgenteBasico,89996067,89996062,-5,5,-1,107
4354,AgenteBasico,89996062,89996067,5,5,1,102
4355,AgenteBasico,89996067,89996062,-5,5,-1,97
4356,AgenteBasico,89996062,89996052,-10,10,-1,93
4357,AgenteBasico,89996052,89996047,-5,5,-1,87
4358,AgenteBasico,89996047,89996042,-5,5,-1,81
4359,AgenteBasico,89996042,89996037,-5,5,-1,75
4360,AgenteBasico,89996037,89996032,-5,5,-1,69
4361,AgenteBasico,89996032,89996037,5,5,1,64
4362,AgenteBasico,89996037,89996042,5,5,1,59
4363,AgenteBasico,89996042,89996057,15,15,1,54
4364,AgenteBasico,89996057,89996047,-10,10,-1,46
4365,AgenteBasico,89996047,89996052,5,5,1,40
4366,AgenteBasico,89996052,89996052,0,10,0,34
4367,AgenteBasico,89996052,89996047,-5,5,-1,201
4368,AgenteBasico,89996047,89996052,5,5,1,196
4369,AgenteBasico,89996052,89996062,10,10,1,190
4370,AgenteBasico,89996062,89996057,-5,5,-1,182
4371,AgenteBasico,89996057,89996052,-5,5,-1,176
4372,AgenteBasico,89996052,89996057,5,5,1,172
4373,AgenteBasico,89996057,89996057,0,5,0,166
4374,AgenteBasico,89996057,89996052,-5,5,-1,160
4375,AgenteBasico,89996052,89996057,5,5,1,154
4376,AgenteBasico,89996057,89996062,5,5,1,149
4377,AgenteBasico,89996062,89996057,-5,5,-1,144
4378,AgenteBasico,89996057,89996042,-15,15,-1,137
4379,AgenteBasico,89996042,89996047,5,5,1,129
4380,AgenteBasico,89996047,89996042,-5,5,-1,123
4381,AgenteBasico,89996042,89996037,-5,5,-1,116
4382,AgenteBasico,89996037,89996032,-5,5,-1,110
4383,AgenteBasico,89996032,89996027,-5,5,-1,105
4384,AgenteBasico,89996027,89996032,5,5,1,101
4385,AgenteBasico,89996032,89996029,-3,0,-1,95
4386,AgenteBasico,89996029,89996029,0,5,0,91
4387,AgenteBasico,89996029,89996024,-5,5,-1,87
4388,AgenteBasico,89996024,89996019,-5,5,-1,82
4389,AgenteBasico,89996019,89996024,5,5,1,75
4390,AgenteBasico,89996024,89996019,-5,5,-1,70
4391,AgenteBasico,89996019,89996024,5,5,1,63
4392,AgenteBasico,89996024,89996019,-5,5,-1,56
4393,AgenteBasico,89996019,89996019,0,5,0,52
4394,AgenteBasico,89996019,89996014,-5,5,-1,47
4395,AgenteBasico,89996014,89996009,-5,5,-1,42
4396,AgenteBasico,89996009,89996014,5,5,1,37
4397,AgenteBasico,89996014,89996014,0,5,0,31
4398,AgenteBasico,89996014,89996014,0,5,0,204
4399,AgenteBasico,89996014,89996019,5,5,1,200
4400,AgenteBasico,89996019,89996014,-5,5,-1,195
4401,AgenteBasico,89996014,89996019,5,5,1,188
4402,AgenteBasico,89996019,89996014,-5,5,-1,181
4403,AgenteBasico,89996014,89996021,7,5,1,175
4404,AgenteBasico,89996021,89996031,10,10,1,169
4405,AgenteBasico,89996031,89996036,5,5,1,163
4406,AgenteBasico,89996036,89996031,-5,5,-1,158
4407,AgenteBasico,89996031,89996036,5,5,1,152
4408,AgenteBasico,89996036,89996031,-5,5,-1,147
4409,AgenteBasico,89996031,89996026,-5,5,-1,141
4410,AgenteBasico,89996026,89996026,0,5,0,136
4411,AgenteBasico,89996026,89996026,0,10,0,132
4412,AgenteBasico,89996026,89996021,-5,5,-1,126
4413,AgenteBasico,89996021,89996021,0,5,0,119
4414,AgenteBasico,89996021,89996021,0,10,0,113
4415,AgenteBasico,89996021,89996021,0,5,0,106
4416,AgenteBasico,89996021,89996021,0,5,0,102
4417,AgenteBasico,89996021,89996016,-5,5,-1,98
4418,AgenteBasico,89996016,89996011,-5,5,-1,93
4419,AgenteBasico,89996011,89996011,0,5,0,88
4420,AgenteBasico,89996011,89996011,0,5,0,82
4421,AgenteBasico,89996011,89996006,-5,5,-1,78
4422,AgenteBasico,89996006,89996001,-5,5,-1,74
4423,AgenteBasico,89996001,89996001,0,5,0,68
4424,AgenteBasico,89996001,89996006,5,5,1,63
4425,AgenteBasico,89996006,89996006,0,5,0,56
4426,AgenteBasico,89996006,89996003,-3,0,-1,51
4427,AgenteBasico,89996003,89995998,-5,5,-1,204
4428,AgenteBasico,89995998,89996003,5,5,1,199
4429,AgenteBasico,89996003,89996003,0,5,0,192
4430,AgenteBasico,89996003,89996003,0,5,0,187
4431,AgenteBasico,89996003,89995993,-10,10,-1,183
4432,AgenteBasico,89995993,89995993,0,5,0,178
4433,AgenteBasico,89995993,89995988,-5,5,-1,174
4434,AgenteBasico,89995988,89995983,-5,5,-1,168
4435,AgenteBasico,89995983,89995988,5,5,1,162
4436,AgenteBasico,89995988,89995983,-5,5,-1,155
4437,AgenteBasico,89995983,89995983,0,5,0,149
4438,AgenteBasico,89995983,89995983,0,5,0,144
4439,AgenteBasico,89995983,89995978,-5,5,-1,137
4440,AgenteBasico,89995978,89995973,-5,5,-1,131
4441,AgenteBasico,89995973,89995973,0,10,0,124
4442,AgenteBasico,89995973,89995968,-5,5,-1,119
4443,AgenteBasico,89995968,89995968,0,5,0,114
4444,AgenteBasico,89995968,89995963,-5,5,-1,110
4445,AgenteBasico,89995963,89995970,7,5,1,103
4446,AgenteBasico,89995970,89995975,5,5,1,99
4447,AgenteBasico,89995975,89995980,5,5,1,93
4448,AgenteBasico,89995980,89995980,0,5,0,87
4449,AgenteBasico,89995980,89995980,0,5,0,82
4450,AgenteBasico,89995980,89995975,-5,5,-1,77
4451,AgenteBasico,89995975,89995980,5,5,1,71
4452,AgenteBasico,89995980,89995975,-5,5,-1,65
4453,AgenteBasico,89995975,89995975,0,5,0,59
4454,AgenteBasico,89995975,89995970,-5,5,-1,54
4455,AgenteBasico,89995970,89995980,10,10,1,48
4456,AgenteBasico,89995980,89995975,-5,5,-1,198
4457,AgenteBasico,89995975,89995972,-3,0,-1,192
4458,AgenteBasico,89995972,89995967,-5,5,-1,188
4459,AgenteBasico,89995967,89995957,-10,10,-1,183
4460,AgenteBasico,89995957,89995957,0,5,0,178
4461,AgenteBasico,89995957,89995952,-5,5,-1,169
4462,AgenteBasico,89995952,89995957,5,5,1,165
4463,AgenteBasico,89995957,89995952,-5,5,-1,159
4464,AgenteBasico,89995952,89995952,0,5,0,151
4465,AgenteBasico,89995952,89995952,0,5,0,146
4466,AgenteBasico,89995952,89995947,-5,5,-1,142
4467,AgenteBasico,89995947,89995952,5,5,1,136
4468,AgenteBasico,89995952,89995947,-5,5,-1,131
4469,AgenteBasico,89995947,89995942,-5,5,-1,125
4470,AgenteBasico,89995942,89995942,0,5,0,120
4471,AgenteBasico,89995942,89995942,0,5,0,115
4472,AgenteBasico,89995942,89995937,-5,5,-1,110
4473,AgenteBasico,89995937,89995937,0,5,0,105
4474,AgenteBasico,89995937,89995947,10,10,1,100
4475,AgenteBasico,89995947,89995942,-5,5,-1,94
4476,AgenteBasico,89995942,89995947,5,5,1,89
4477,AgenteBasico,89995947,89995954,7,5,1,84
4478,AgenteBasico,89995954,89995949,-5,5,-1,80
4479,AgenteBasico,89995949,89995959,10,10,1,73
4480,AgenteBasico,89995959,89995954,-5,5,-1,67
4481,AgenteBasico,89995954,89995959,5,5,1,62
4482,AgenteBasico,89995959,89995956,-3,0,-1,56
4483,AgenteBasico,89995956,89995951,-5,5,-1,52
4484,AgenteBasico,89995951,89995951,0,5,0,45
4485,AgenteBasico,89995951,89995956,5,5,1,40
4486,AgenteBasico,89995956,89995953,-3,0,-1,34
4487,AgenteBasico,89995953,89995948,-5,5,-1,204
4488,AgenteBasico,89995948,89995948,0,5,0,198
4489,AgenteBasico,89995948,89995938,-10,10,-1,192
4490,AgenteBasico,89995938,89995933,-5,5,-1,186
4491,AgenteBasico,89995933,89995928,-5,5,-1,180
4492,AgenteBasico,89995928,89995933,5,5,1,176
4493,AgenteBasico,89995933,89995930,-3,0,-1,170
4494,AgenteBasico,89995930,89995925,-5,5,-1,165
4495,AgenteBasico,89995925,89995915,-10,10,-1,160
4496,AgenteBasico,89995915,89995915,0,5,0,154
4497,AgenteBasico,89995915,89995910,-5,5,-1,149
4498,AgenteBasico,89995910,89995905,-5,5,-1,144
4499,AgenteBasico,89995905,89995905,0,5,0,138
4500,AgenteBasico,89995905,89995900,-5,5,-1,134
4501,AgenteBasico,89995900,89995905,5,5,1,128
4502,AgenteBasico,89995905,89995900,-5,5,-1,123
4503,AgenteBasico,89995900,89995907,7,5,1,117
4504,AgenteBasico,89995907,89995902,-5,5,-1,111
4505,AgenteBasico,89995902,89995907,5,5,1,107
4506,AgenteBasico,89995907,89995902,-5,5,-1,102
4507,AgenteBasico,89995902,89995907,5,5,1,97
4508,AgenteBasico,89995907,89995902,-5,5,-1,91
4509,AgenteBasico,89995902,89995897,-5,5,-1,86
4510,AgenteBasico,89995897,89995902,5,5,1,81
4511,AgenteBasico,89995902,89995897,-5,5,-1,74
4512,AgenteBasico,89995897,89995892,-5,5,-1,69
4513,AgenteBasico,89995892,89995887,-5,5,-1,63
4514,AgenteBasico,89995887,89995892,5,5,1,58
4515,AgenteBasico,89995892,89995887,-5,5,-1,53
4516,AgenteBasico,89995887,89995892,5,5,1,47
4517,AgenteBasico,89995892,89995882,-10,10,-1,41
4518,AgenteBasico,89995882,89995887,5,5,1,34
4519,AgenteBasico,89995887,89995887,0,10,0,202
4520,AgenteBasico,89995887,89995887,0,5,0,196
4521,AgenteBasico,89995887,89995882,-5,5,-1,191
4522,AgenteBasico,89995882,89995877,-5,5,-1,186
4523,AgenteBasico,89995877,89995872,-5,5,-1,180
4524,AgenteBasico,89995872,89995877,5,5,1,174
4525,AgenteBasico,89995877,89995882,5,5,1,168
4526,AgenteBasico,89995882,89995877,-5,5,-1,163
4527,AgenteBasico,89995877,89995877,0,5,0,158
4528,AgenteBasico,89995877,89995872,-5,5,-1,154
4529,AgenteBasico,89995872,89995872,0,5,0,150
4530,AgenteBasico,89995872,89995872,0,5,0,144
4531,AgenteBasico,89995872,89995867,-5,5,-1,139
4532,AgenteBasico,89995867,89995862,-5,5,-1,133
4533,AgenteBasico,89995862,89995857,-5,5,-1,126
4534,AgenteBasico,89995857,89995862,5,5,1,121
4535,AgenteBasico,89995862,89995857,-5,5,-1,116
4536,AgenteBasico,89995857,89995852,-5,5,-1,110
4537,AgenteBasico,89995852,89995852,0,5,0,102
4538,AgenteBasico,89995852,89995847,-5,5,-1,97
4539,AgenteBasico,89995847,89995852,5,5,1,92
4540,AgenteBasico,89995852,89995847,-5,5,-1,85
4541,AgenteBasico,89995847,89995842,-5,5,-1,79
4542,AgenteBasico,89995842,89995837,-5,5,-1,74
4543,AgenteBasico,89995837,89995832,-5,5,-1,68
4544,AgenteBasico,89995832,89995832,0,5,0,63
4545,AgenteBasico,89995832,89995837,5,5,1,58
4546,AgenteBasico,89995837,89995837,0,5,0,53
4547,AgenteBasico,89995837,89995847,10,10,1,48
4548,AgenteBasico,89995847,89995844,-3,0,-1,40
4549,AgenteBasico,89995844,89995839,-5,5,-1,36
4550,AgenteBasico,89995839,89995849,10,10,1,203
4551,AgenteBasico,89995849,89995844,-5,5,-1,197
4552,AgenteBasico,89995844,89995841,-3,0,-1,192
4553,AgenteBasico,89995841,89995848,7,5,1,188
4554,AgenteBasico,89995848,89995848,0,5,0,184
4555,AgenteBasico,89995848,89995843,-5,5,-1,179
4556,AgenteBasico,89995843,89995838,-5,5,-1,174
4557,AgenteBasico,89995838,89995838,0,10,0,169
4558,AgenteBasico,89995838,89995843,5,5,1,164
4559,AgenteBasico,89995843,89995843,0,5,0,159
4560,AgenteBasico,89995843,89995838,-5,5,-1,154
4561,AgenteBasico,89995838,89995833,-5,5,-1,147
4562,AgenteBasico,89995833,89995828,-5,5,-1,142
4563,AgenteBasico,89995828,89995835,7,5,1,137
4564,AgenteBasico,89995835,89995835,0,5,0,133
4565,AgenteBasico,89995835,89995830,-5,5,-1,128
4566,AgenteBasico,89995830,89995825,-5,5,-1,121
4567,AgenteBasico,89995825,89995815,-10,10,-1,114
4568,AgenteBasico,89995815,89995805,-10,10,-1,108
4569,AgenteBasico,89995805,89995810,5,5,1,102
4570,AgenteBasico,89995810,89995815,5,5,1,96
4571,AgenteBasico,89995815,89995810,-5,5,-1,90
4572,AgenteBasico,89995810,89995815,5,5,1,84
4573,AgenteBasico,89995815,89995810,-5,5,-1,77
4574,AgenteBasico,89995810,89995815,5,5,1,71
4575,AgenteBasico,89995815,89995810,-5,5,-1,66
4576,AgenteBasico,89995810,89995810,0,5,0,60
4577,AgenteBasico,89995810,89995810,0,5,0,56
4578,AgenteBasico,89995810,89995805,-5,5,-1,51
4579,AgenteBasico,89995805,89995815,10,10,1,203
4580,AgenteBasico,89995815,89995810,-5,5,-1,196
4581,AgenteBasico,89995810,89995805,-5,5,-1,189
4582,AgenteBasico,89995805,89995805,0,5,0,182
4583,AgenteBasico,89995805,89995805,0,5,0,178
4584,AgenteBasico,89995805,89995800,-5,5,-1,172
4585,AgenteBasico,89995800,89995795,-5,5,-1,168
4586,AgenteBasico,89995795,89995795,0,10,0,162
4587,AgenteBasico,89995795,89995795,0,5,0,157
4588,AgenteBasico,89995795,89995800,5,5,1,151
4589,AgenteBasico,89995800,89995805,5,5,1,145
4590,AgenteBasico,89995805,89995800,-5,5,-1,140
4591,AgenteBasico,89995800,89995800,0,5,0,135
4592,AgenteBasico,89995800,89995790,-10,10,-1,128
4593,AgenteBasico,89995790,89995780,-10,10,-1,123
4594,AgenteBasico,89995780,89995775,-5,5,-1,117
4595,AgenteBasico,89995775,89995775,0,5,0,112
4596,AgenteBasico,89995775,89995770,-5,5,-1,105
4597,AgenteBasico,89995770,89995765,-5,5,-1,100
4598,AgenteBasico,89995765,89995760,-5,5,-1,93
4599,AgenteBasico,89995760,89995755,-5,5,-1,88
4600,AgenteBasico,89995755,89995760,5,5,1,81
4601,AgenteBasico,89995760,89995755,-5,5,-1,76
4602,AgenteBasico,89995755,89995750,-5,5,-1,71
4603,AgenteBasico,89995750,89995750,0,5,0,67
4604,AgenteBasico,89995750,89995745,-5,5,-1,62
4605,AgenteBasico,89995745,89995740,-5,5,-1,56
4606,AgenteBasico,89995740,89995730,-10,20,-1,50
4607,AgenteBasico,89995730,89995725,-5,5,-1,42
4608,AgenteBasico,89995725,89995720,-5,5,-1,37
4609,AgenteBasico,89995720,89995720,0,5,0,31
4610,AgenteBasico,89995720,89995720,0,5,0,203
4611,AgenteBasico,89995720,89995720,0,5,0,198
4612,AgenteBasico,89995720,89995730,10,10,1,189
4613,AgenteBasico,89995730,89995725,-5,5,-1,183
4614,AgenteBasico,89995725,89995720,-5,5,-1,178
4615,AgenteBasico,89995720,89995715,-5,5,-1,173
4616,AgenteBasico,89995715,89995720,5,5,1,168
4617,AgenteBasico,89995720,89995715,-5,5,-1,162
4618,AgenteBasico,89995715,89995720,5,5,1,156
4619,AgenteBasico,89995720,89995715,-5,5,-1,151
4620,AgenteBasico,89995715,89995720,5,5,1,146
4621,AgenteBasico,89995720,89995720,0,5,0,140
4622,AgenteBasico,89995720,89995715,-5,5,-1,135
4623,AgenteBasico,89995715,89995720,5,5,1,129
4624,AgenteBasico,89995720,89995725,5,5,1,123
4625,AgenteBasico,89995725,89995730,5,5,1,117
4626,AgenteBasico,89995730,89995725,-5,5,-1,112
4627,AgenteBasico,89995725,89995730,5,5,1,107
4628,AgenteBasico,89995730,89995735,5,5,1,100
4629,AgenteBasico,89995735,89995730,-5,5,-1,95
4630,AgenteBasico,89995730,89995735,5,5,1,90
4631,AgenteBasico,89995735,89995732,-3,0,-1,83
4632,AgenteBasico,89995732,89995737,5,5,1,78
4633,AgenteBasico,89995737,89995732,-5,5,-1,71
4634,AgenteBasico,89995732,89995727,-5,5,-1,66
4635,AgenteBasico,89995727,89995734,7,5,1,60
4636,AgenteBasico,89995734,89995734,0,5,0,55
4637,AgenteBasico,89995734,89995729,-5,5,-1,49
4638,AgenteBasico,89995729,89995719,-10,10,-1,44
4639,AgenteBasico,89995719,89995724,5,5,1,36
4640,AgenteBasico,89995724,89995719,-5,5,-1,30
4641,AgenteBasico,89995719,89995714,-5,5,-1,204
4642,AgenteBasico,89995714,89995714,0,5,0,197
4643,AgenteBasico,89995714,89995709,-5,5,-1,193
4644,AgenteBasico,89995709,89995709,0,5,0,186
4645,AgenteBasico,89995709,89995719,10,10,1,179
4646,AgenteBasico,89995719,89995714,-5,5,-1,173
4647,AgenteBasico,89995714,89995709,-5,5,-1,167
4648,AgenteBasico,89995709,89995714,5,5,1,162
4649,AgenteBasico,89995714,89995709,-5,5,-1,157
4650,AgenteBasico,89995709,89995709,0,10,0,152
4651,AgenteBasico,89995709,89995704,-5,5,-1,146
4652,AgenteBasico,89995704,89995699,-5,5,-1,141
4653,AgenteBasico,89995699,89995694,-5,5,-1,136
4654,AgenteBasico,89995694,89995689,-5,5,-1,130
4655,AgenteBasico,89995689,89995684,-5,5,-1,125
4656,AgenteBasico,89995684,89995684,0,5,0,121
4657,AgenteBasico,89995684,89995684,0,5,0,116
4658,AgenteBasico,89995684,89995684,0,5,0,112
4659,AgenteBasico,89995684,89995679,-5,5,-1,107
4660,AgenteBasico,89995679,89995684,5,5,1,101
4661,AgenteBasico,89995684,89995689,5,5,1,93
4662,AgenteBasico,89995689,89995686,-3,0,-1,87
4663,AgenteBasico,89995686,89995681,-5,5,-1,81
4664,AgenteBasico,89995681,89995686,5,5,1,77
4665,AgenteBasico,89995686,89995676,-10,10,-1,69
4666,AgenteBasico,89995676,89995681,5,5,1,64
4667,AgenteBasico,89995681,89995681,0,10,0,59
4668,AgenteBasico,89995681,89995676,-5,5,-1,52
4669,AgenteBasico,89995676,89995676,0,5,0,48
4670,AgenteBasico,89995676,89995671,-5,5,-1,42
4671,AgenteBasico,89995671,89995676,5,5,1,36
4672,AgenteBasico,89995676,89995671,-5,5,-1,203
4673,AgenteBasico,89995671,89995666,-5,5,-1,198
4674,AgenteBasico,89995666,89995661,-5,5,-1,191
4675,AgenteBasico,89995661,89995666,5,5,1,186
4676,AgenteBasico,89995666,89995671,5,5,1,180
4677,AgenteBasico,89995671,89995676,5,5,1,174
4678,AgenteBasico,89995676,89995681,5,5,1,168
4679,AgenteBasico,89995681,89995686,5,5,1,162
4680,AgenteBasico,89995686,89995686,0,5,0,156
4681,AgenteBasico,89995686,89995691,5,5,1,150
4682,AgenteBasico,89995691,89995691,0,5,0,143
4683,AgenteBasico,89995691,89995691,0,5,0,138
4684,AgenteBasico,89995691,89995696,5,5,1,133
4685,AgenteBasico,89995696,89995701,5,5,1,128
4686,AgenteBasico,89995701,89995701,0,5,0,121
4687,AgenteBasico,89995701,89995701,0,5,0,116
4688,AgenteBasico,89995701,89995691,-10,10,-1,111
4689,AgenteBasico,89995691,89995686,-5,5,-1,105
4690,AgenteBasico,89995686,89995681,-5,5,-1,100
4691,AgenteBasico,89995681,89995676,-5,5,-1,94
4692,AgenteBasico,89995676,89995671,-5,5,-1,87
4693,AgenteBasico,89995671,89995681,10,10,1,82
4694,AgenteBasico,89995681,89995676,-5,5,-1,76
4695,AgenteBasico,89995676,89995676,0,5,0,71
4696,AgenteBasico,89995676,89995671,-5,5,-1,67
4697,AgenteBasico,89995671,89995661,-10,10,-1,61
4698,AgenteBasico,89995661,89995666,5,5,1,56
4699,AgenteBasico,89995666,89995661,-5,5,-1,51
4700,AgenteBasico,89995661,89995666,5,5,1,44
4701,AgenteBasico,89995666,89995661,-5,5,-1,36
4702,AgenteBasico,89995661,89995666,5,5,1,202
4703,AgenteBasico,89995666,89995673,7,5,1,196
4704,AgenteBasico,89995673,89995673,0,10,0,192
4705,AgenteBasico,89995673,89995668,-5,5,-1,185
4706,AgenteBasico,89995668,89995663,-5,5,-1,180
4707,AgenteBasico,89995663,89995658,-5,5,-1,173
4708,AgenteBasico,89995658,89995663,5,5,1,167
4709,AgenteBasico,89995663,89995663,0,5,0,158
4710,AgenteBasico,89995663,89995663,0,10,0,153
4711,AgenteBasico,89995663,89995653,-10,10,-1,147
4712,AgenteBasico,89995653,89995653,0,5,0,140
4713,AgenteBasico,89995653,89995648,-5,5,-1,135
4714,AgenteBasico,89995648,89995643,-5,5,-1,130
4715,AgenteBasico,89995643,89995638,-5,5,-1,125
4716,AgenteBasico,89995638,89995633,-5,5,-1,120
4717,AgenteBasico,89995633,89995628,-5,5,-1,114
4718,AgenteBasico,89995628,89995623,-5,5,-1,107
4719,AgenteBasico,89995623,89995618,-5,5,-1,102
4720,AgenteBasico,89995618,89995615,-3,0,-1,96
4721,AgenteBasico,89995615,89995610,-5,5,-1,91
4722,AgenteBasico,89995610,89995620,10,10,1,86
4723,AgenteBasico,89995620,89995615,-5,5,-1,79
4724,AgenteBasico,89995615,89995625,10,10,1,74
4725,AgenteBasico,89995625,89995620,-5,5,-1,67
4726,AgenteBasico,89995620,89995620,0,5,0,62
4727,AgenteBasico,89995620,89995615,-5,5,-1,57
4728,AgenteBasico,89995615,89995610,-5,5,-1,50
4729,AgenteBasico,89995610,89995605,-5,5,-1,44
4730,AgenteBasico,89995605,89995605,0,5,0,203
4731,AgenteBasico,89995605,89995610,5,5,1,198
4732,AgenteBasico,89995610,89995605,-5,5,-1,191
4733,AgenteBasico,89995605,89995615,10,10,1,185
4734,AgenteBasico,89995615,89995615,0,5,0,179
4735,AgenteBasico,89995615,89995620,5,5,1,175
4736,AgenteBasico,89995620,89995615,-5,5,-1,170
4737,AgenteBasico,89995615,89995620,5,5,1,166
4738,AgenteBasico,89995620,89995627,7,5,1,161
4739,AgenteBasico,89995627,89995622,-5,5,-1,156
4740,AgenteBasico,89995622,89995619,-3,0,-1,151
4741,AgenteBasico,89995619,89995614,-5,5,-1,147
4742,AgenteBasico,89995614,89995619,5,5,1,142
4743,AgenteBasico,89995619,89995629,10,10,1,135
4744,AgenteBasico,89995629,89995634,5,5,1,129
4745,AgenteBasico,89995634,89995639,5,5,1,124
4746,AgenteBasico,89995639,89995624,-15,15,-1,119
4747,AgenteBasico,89995624,89995629,5,5,1,110
4748,AgenteBasico,89995629,89995624,-5,5,-1,104
4749,AgenteBasico,89995624,89995619,-5,5,-1,100
4750,AgenteBasico,89995619,89995624,5,5,1,95
4751,AgenteBasico,89995624,89995619,-5,5,-1,88
4752,AgenteBasico,89995619,89995619,0,5,0,83
4753,AgenteBasico,89995619,89995619,0,10,0,78
4754,AgenteBasico,89995619,89995629,10,10,1,73
4755,AgenteBasico,89995629,89995629,0,5,0,67
4756,AgenteBasico,89995629,89995629,0,5,0,62
4757,AgenteBasico,89995629,89995624,-5,5,-1,55
4758,AgenteBasico,89995624,89995629,5,5,1,49
4759,AgenteBasico,89995629,89995629,0,10,0,42
4760,AgenteBasico,89995629,89995634,5,5,1,36
4761,AgenteBasico,89995634,89995629,-5,5,-1,31
4762,AgenteBasico,89995629,89995634,5,5,1,203
4763,AgenteBasico,89995634,89995634,0,10,0,197
4764,AgenteBasico,89995634,89995644,10,10,1,191
4765,AgenteBasico,89995644,89995644,0,5,0,185
4766,AgenteBasico,89995644,89995639,-5,5,-1,179
4767,AgenteBasico,89995639,89995649,10,10,1,174
4768,AgenteBasico,89995649,89995654,5,5,1,167
4769,AgenteBasico,89995654,89995654,0,5,0,161
4770,AgenteBasico,89995654,89995654,0,5,0,157
4771,AgenteBasico,89995654,89995659,5,5,1,152
4772,AgenteBasico,89995659,89995659,0,5,0,147
4773,AgenteBasico,89995659,89995659,0,5,0,141
4774,AgenteBasico,89995659,89995654,-5,5,-1,137
4775,AgenteBasico,89995654,89995659,5,5,1,133
4776,AgenteBasico,89995659,89995654,-5,5,-1,127
4777,AgenteBasico,89995654,89995649,-5,5,-1,122
4778,AgenteBasico,89995649,89995644,-5,5,-1,117
4779,AgenteBasico,89995644,89995644,0,5,0,112
4780,AgenteBasico,89995644,89995639,-5,5,-1,106
4781,AgenteBasico,89995639,89995629,-10,10,-1,99
4782,AgenteBasico,89995629,89995624,-5,5,-1,93
4783,AgenteBasico,89995624,89995629,5,5,1,85
4784,AgenteBasico,89995629,89995629,0,10,0,79
4785,AgenteBasico,89995629,89995634,5,5,1,73
4786,AgenteBasico,89995634,89995629,-5,5,-1,68
4787,AgenteBasico,89995629,89995624,-5,5,-1,64
4788,AgenteBasico,89995624,89995631,7,5,1,56
4789,AgenteBasico,89995631,89995631,0,5,0,52
4790,AgenteBasico,89995631,89995626,-5,5,-1,48
4791,AgenteBasico,89995626,89995626,0,5,0,43
4792,AgenteBasico,89995626,89995626,0,5,0,38
4793,AgenteBasico,89995626,89995626,0,10,0,34
4794,AgenteBasico,89995626,89995621,-5,5,-1,203
4795,AgenteBasico,89995621,89995606,-15,15,-1,197
4796,AgenteBasico,89995606,89995611,5,5,1,188
4797,AgenteBasico,89995611,89995616,5,5,1,182
4798,AgenteBasico,89995616,89995621,5,5,1,177
4799,AgenteBasico,89995621,89995611,-10,10,-1,172
4800,AgenteBasico,89995611,89995606,-5,5,-1,165
4801,AgenteBasico,89995606,89995611,5,5,1,159
4802,AgenteBasico,89995611,89995606,-5,5,-1,152
4803,AgenteBasico,89995606,89995603,-3,0,-1,145
4804,AgenteBasico,89995603,89995603,0,10,0,141
4805,AgenteBasico,89995603,89995593,-10,10,-1,136
4806,AgenteBasico,89995593,89995598,5,5,1,131
4807,AgenteBasico,89995598,89995595,-3,0,-1,126
4808,AgenteBasico,89995595,89995595,0,5,0,121
4809,AgenteBasico,89995595,89995600,5,5,1,115
4810,AgenteBasico,89995600,89995605,5,5,1,109
4811,AgenteBasico,89995605,89995600,-5,5,-1,102
4812,AgenteBasico,89995600,89995600,0,5,0,97
4813,AgenteBasico,89995600,89995610,10,10,1,93
4814,AgenteBasico,89995610,89995605,-5,5,-1,87
4815,AgenteBasico,89995605,89995612,7,5,1,80
4816,AgenteBasico,89995612,89995617,5,5,1,76
4817,AgenteBasico,89995617,89995617,0,5,0,71
4818,AgenteBasico,89995617,89995622,5,5,1,66
4819,AgenteBasico,89995622,89995627,5,5,1,60
4820,AgenteBasico,89995627,89995622,-5,5,-1,54
4821,AgenteBasico,89995622,89995617,-5,5,-1,49
4822,AgenteBasico,89995617,89995617,0,5,0,44
4823,AgenteBasico,89995617,89995622,5,5,1,203
4824,AgenteBasico,89995622,89995622,0,5,0,198
4825,AgenteBasico,89995622,89995617,-5,5,-1,193
4826,AgenteBasico,89995617,89995614,-3,0,-1,188
4827,AgenteBasico,89995614,89995614,0,5,0,184
4828,AgenteBasico,89995614,89995609,-5,5,-1,179
4829,AgenteBasico,89995609,89995609,0,10,0,175
4830,AgenteBasico,89995609,89995614,5,5,1,169
4831,AgenteBasico,89995614,89995609,-5,5,-1,164
4832,AgenteBasico,89995609,89995599,-10,10,-1,159
4833,AgenteBasico,89995599,89995594,-5,5,-1,153
4834,AgenteBasico,89995594,89995599,5,5,1,146
4835,AgenteBasico,89995599,89995609,10,10,1,140
4836,AgenteBasico,89995609,89995619,10,10,1,134
4837,AgenteBasico,89995619,89995614,-5,5,-1,125
4838,AgenteBasico,89995614,89995621,7,5,1,121
4839,AgenteBasico,89995621,89995616,-5,5,-1,116
4840,AgenteBasico,89995616,89995621,5,5,1,110
4841,AgenteBasico,89995621,89995616,-5,5,-1,104
4842,AgenteBasico,89995616,89995623,7,5,1,99
4843,AgenteBasico,89995623,89995628,5,5,1,94
4844,AgenteBasico,89995628,89995628,0,5,0,89
4845,AgenteBasico,89995628,89995623,-5,5,-1,84
4846,AgenteBasico,89995623,89995618,-5,5,-1,79
4847,AgenteBasico,89995618,89995628,10,10,1,71
4848,AgenteBasico,89995628,89995628,0,5,0,65
4849,AgenteBasico,89995628,89995628,0,10,0,60
4850,AgenteBasico,89995628,89995633,5,5,1,55
4851,AgenteBasico,89995633,89995628,-5,5,-1,50
4852,AgenteBasico,89995628,89995625,-3,0,-1,202
4853,AgenteBasico,89995625,89995625,0,5,0,198
4854,AgenteBasico,89995625,89995625,0,5,0,194
4855,AgenteBasico,89995625,89995625,0,5,0,188
4856,AgenteBasico,89995625,89995635,10,10,1,184
4857,AgenteBasico,89995635,89995635,0,5,0,178
4858,AgenteBasico,89995635,89995630,-5,5,-1,173
4859,AgenteBasico,89995630,89995637,7,5,1,167
4860,AgenteBasico,89995637,89995642,5,5,1,163
4861,AgenteBasico,89995642,89995649,7,5,1,157
4862,AgenteBasico,89995649,89995639,-10,10,-1,152
4863,AgenteBasico,89995639,89995644,5,5,1,146
4864,AgenteBasico,89995644,89995644,0,5,0,138
4865,AgenteBasico,89995644,89995651,7,5,1,132
4866,AgenteBasico,89995651,89995651,0,5,0,126
4867,AgenteBasico,89995651,89995646,-5,5,-1,121
4868,AgenteBasico,89995646,89995641,-5,5,-1,115
4869,AgenteBasico,89995641,89995636,-5,5,-1,110
4870,AgenteBasico,89995636,89995631,-5,5,-1,105
4871,AgenteBasico,89995631,89995631,0,5,0,99
4872,AgenteBasico,89995631,89995631,0,5,0,95
4873,AgenteBasico,89995631,89995626,-5,5,-1,91
4874,AgenteBasico,89995626,89995623,-3,0,-1,85
4875,AgenteBasico,89995623,89995623,0,5,0,81
4876,AgenteBasico,89995623,89995623,0,5,0,75
4877,AgenteBasico,89995623,89995623,0,5,0,71
4878,AgenteBasico,89995623,89995618,-5,5,-1,66
4879,AgenteBasico,89995618,89995613,-5,5,-1,60
4880,AgenteBasico,89995613,89995618,5,5,1,54
4881,AgenteBasico,89995618,89995613,-5,5,-1,48
4882,AgenteBasico,89995613,89995618,5,5,1,43
4883,AgenteBasico,89995618,89995613,-5,5,-1,37
4884,AgenteBasico,89995613,89995608,-5,5,-1,32
4885,AgenteBasico,89995608,89995603,-5,5,-1,27
4886,AgenteBasico,89995603,89995598,-5,5,-1,203
4887,AgenteBasico,89995598,89995598,0,5,0,197
4888,AgenteBasico,89995598,89995593,-5,5,-1,191
4889,AgenteBasico,89995593,89995588,-5,5,-1,185
4890,AgenteBasico,89995588,89995588,0,5,0,180
4891,AgenteBasico,89995588,89995583,-5,5,-1,176
4892,AgenteBasico,89995583,89995593,10,10,1,172
4893,AgenteBasico,89995593,89995588,-5,5,-1,166
4894,AgenteBasico,89995588,89995583,-5,5,-1,159
4895,AgenteBasico,89995583,89995578,-5,5,-1,154
4896,AgenteBasico,89995578,89995573,-5,5,-1,148
4897,AgenteBasico,89995573,89995573,0,5,0,144
4898,AgenteBasico,89995573,89995583,10,10,1,140
4899,AgenteBasico,89995583,89995578,-5,5,-1,134
4900,AgenteBasico,89995578,89995578,0,10,0,124
4901,AgenteBasico,89995578,89995573,-5,5,-1,119
4902,AgenteBasico,89995573,89995578,5,5,1,114
4903,AgenteBasico,89995578,89995578,0,5,0,109
4904,AgenteBasico,89995578,89995588,10,10,1,104
4905,AgenteBasico,89995588,89995588,0,5,0,98
4906,AgenteBasico,89995588,89995583,-5,5,-1,93
4907,AgenteBasico,89995583,89995578,-5,5,-1,89
4908,AgenteBasico,89995578,89995573,-5,5,-1,83
4909,AgenteBasico,89995573,89995578,5,5,1,76
4910,AgenteBasico,89995578,89995578,0,10,0,71
4911,AgenteBasico,89995578,89995583,5,5,1,63
4912,AgenteBasico,89995583,89995578,-5,5,-1,57
4913,AgenteBasico,89995578,89995573,-5,5,-1,52
4914,AgenteBasico,89995573,89995573,0,5,0,46
4915,AgenteBasico,89995573,89995578,5,5,1,42
4916,AgenteBasico,89995578,89995573,-5,5,-1,35
4917,AgenteBasico,89995573,89995578,5,5,1,30
4918,AgenteBasico,89995578,89995573,-5,5,-1,201
4919,AgenteBasico,89995573,89995568,-5,5,-1,196
4920,AgenteBasico,89995568,89995563,-5,5,-1,191
4921,AgenteBasico,89995563,89995548,-15,25,-1,186
4922,AgenteBasico,89995548,89995543,-5,5,-1,175
4923,AgenteBasico,89995543,89995538,-5,5,-1,170
4924,AgenteBasico,89995538,89995533,-5,5,-1,164
4925,AgenteBasico,89995533,89995533,0,5,0,158
4926,AgenteBasico,89995533,89995528,-5,5,-1,152
4927,AgenteBasico,89995528,89995528,0,5,0,147
4928,AgenteBasico,89995528,89995528,0,5,0,142
4929,AgenteBasico,89995528,89995528,0,5,0,138
4930,AgenteBasico,89995528,89995523,-5,5,-1,134
4931,AgenteBasico,89995523,89995523,0,5,0,128
4932,AgenteBasico,89995523,89995513,-10,10,-1,123
4933,AgenteBasico,89995513,89995518,5,5,1,117
4934,AgenteBasico,89995518,89995513,-5,5,-1,110
4935,AgenteBasico,89995513,89995508,-5,5,-1,105
4936,AgenteBasico,89995508,89995508,0,5,0,100
4937,AgenteBasico,89995508,89995503,-5,5,-1,96
4938,AgenteBasico,89995503,89995498,-5,5,-1,91
4939,AgenteBasico,89995498,89995495,-3,0,-1,86
4940,AgenteBasico,89995495,89995490,-5,5,-1,82
4941,AgenteBasico,89995490,89995495,5,5,1,74
4942,AgenteBasico,89995495,89995495,0,5,0,68
4943,AgenteBasico,89995495,89995502,7,5,1,63
4944,AgenteBasico,89995502,89995497,-5,5,-1,58
4945,AgenteBasico,89995497,89995492,-5,5,-1,53
4946,AgenteBasico,89995492,89995487,-5,5,-1,46
4947,AgenteBasico,89995487,89995492,5,5,1,40
4948,AgenteBasico,89995492,89995492,0,5,0,33
4949,AgenteBasico,89995492,89995492,0,5,0,203
4950,AgenteBasico,89995492,89995487,-5,5,-1,198
4951,AgenteBasico,89995487,89995484,-3,0,-1,191
4952,AgenteBasico,89995484,89995489,5,5,1,186
4953,AgenteBasico,89995489,89995486,-3,0,-1,179
4954,AgenteBasico,89995486,89995491,5,5,1,175
4955,AgenteBasico,89995491,89995496,5,5,1,169
4956,AgenteBasico,89995496,89995491,-5,5,-1,162
4957,AgenteBasico,89995491,89995491,0,5,0,158
4958,AgenteBasico,89995491,89995491,0,5,0,153
4959,AgenteBasico,89995491,89995491,0,5,0,149
4960,AgenteBasico,89995491,89995486,-5,5,-1,143
4961,AgenteBasico,89995486,89995481,-5,5,-1,137
4962,AgenteBasico,89995481,89995476,-5,5,-1,133
4963,AgenteBasico,89995476,89995481,5,5,1,128
4964,AgenteBasico,89995481,89995491,10,10,1,123
4965,AgenteBasico,89995491,89995491,0,5,0,116
4966,AgenteBasico,89995491,89995491,0,5,0,110
4967,AgenteBasico,89995491,89995486,-5,5,-1,105
4968,AgenteBasico,89995486,89995481,-5,5,-1,100
4969,AgenteBasico,89995481,89995476,-5,5,-1,93
4970,AgenteBasico,89995476,89995471,-5,5,-1,87
4971,AgenteBasico,89995471,89995481,10,10,1,80
4972,AgenteBasico,89995481,89995481,0,5,0,73
4973,AgenteBasico,89995481,89995476,-5,5,-1,68
4974,AgenteBasico,89995476,89995471,-5,5,-1,63
4975,AgenteBasico,89995471,89995466,-5,5,-1,57
4976,AgenteBasico,89995466,89995461,-5,15,-1,52
4977,AgenteBasico,89995461,89995461,0,5,0,44
4978,AgenteBasico,89995461,89995461,0,5,0,39
4979,AgenteBasico,89995461,89995456,-5,5,-1,35
4980,AgenteBasico,89995456,89995451,-5,5,-1,201
4981,AgenteBasico,89995451,89995446,-5,5,-1,196
4982,AgenteBasico,89995446,89995446,0,5,0,192
4983,AgenteBasico,89995446,89995441,-5,5,-1,187
4984,AgenteBasico,89995441,89995441,0,5,0,182
4985,AgenteBasico,89995441,89995448,7,5,1,177
4986,AgenteBasico,89995448,89995443,-5,5,-1,172
4987,AgenteBasico,89995443,89995448,5,5,1,166
4988,AgenteBasico,89995448,89995443,-5,5,-1,161
4989,AgenteBasico,89995443,89995438,-5,5,-1,156
4990,AgenteBasico,89995438,89995433,-5,5,-1,148
4991,AgenteBasico,89995433,89995433,0,5,0,143
4992,AgenteBasico,89995433,89995438,5,5,1,137
4993,AgenteBasico,89995438,89995448,10,10,1,131
4994,AgenteBasico,89995448,89995448,0,5,0,125
4995,AgenteBasico,89995448,89995458,10,10,1,121
4996,AgenteBasico,89995458,89995453,-5,5,-1,115
4997,AgenteBasico,89995453,89995458,5,5,1,109
4998,AgenteBasico,89995458,89995473,15,15,1,101
4999,AgenteBasico,89995473,89995473,0,5,0,92
5000,AgenteBasico,89995473,89995483,10,10,1,88
